Date,y1,y2,y3,y4,y5,y6,sum
20/03/2010,18,26,27,48,51,53,223
21/03/2010,6,15,25,27,30,37,140
24/03/2010,14,17,21,31,38,46,167
27/03/2010,15,18,37,39,44,52,205
28/03/2010,2,8,24,31,33,50,148
30/03/2010,16,26,27,39,40,46,194
31/03/2010,16,19,28,36,47,54,200
3/4/2010,11,21,25,39,43,49,188
4/4/2010,1,22,23,48,49,57,200
6/4/2010,10,12,36,40,45,47,190
7/4/2010,2,6,36,38,49,50,181
10/4/2010,19,22,34,41,48,52,216
11/4/2010,1,21,29,30,35,46,162
14/04/2010,3,9,28,33,37,54,164
17/04/2010,13,14,18,29,30,49,153
18/04/2010,7,12,18,31,41,49,158
21/04/2010,10,11,22,29,36,51,159
24/04/2010,2,3,25,26,29,52,137
25/04/2010,10,13,18,31,50,53,175
27/04/2010,1,9,12,27,45,50,144
28/04/2010,2,20,21,22,31,34,130
1/5/2010,7,19,22,25,44,49,166
2/5/2010,5,23,26,27,43,49,173
4/5/2010,13,18,22,40,48,55,196
5/5/2010,30,33,39,41,43,54,240
8/5/2010,6,30,46,48,56,58,244
9/5/2010,8,10,15,21,31,32,117
12/5/2010,17,39,43,44,50,54,247
15/05/2010,1,13,17,21,37,58,147
16/05/2010,11,28,30,37,39,58,203
19/05/2010,1,14,20,42,48,49,174
22/05/2010,5,7,10,11,13,27,73
23/05/2010,12,16,42,43,48,49,210
26/05/2010,10,27,30,36,38,40,181
29/05/2010,8,14,29,41,43,57,192
30/05/2010,14,26,27,40,41,50,198
1/6/2010,5,21,22,24,27,32,131
2/6/2010,1,16,21,41,49,51,179
5/6/2010,4,17,23,34,41,43,162
6/6/2010,2,18,39,45,46,55,205
9/6/2010,5,11,29,32,47,58,182
12/6/2010,3,4,21,26,54,58,166
13/06/2010,6,7,47,50,52,53,215
16/06/2010,14,25,39,42,47,50,217
19/06/2010,6,12,15,18,25,58,134
20/06/2010,8,22,32,43,45,51,201
23/06/2010,5,6,22,50,52,55,190
26/06/2010,6,10,20,29,41,54,160
27/06/2010,6,18,19,41,45,47,176
29/06/2010,13,19,30,35,38,58,193
30/06/2010,19,20,31,33,47,58,208
3/7/2010,5,15,19,20,45,49,153
4/7/2010,6,14,31,35,43,44,173
6/7/2010,2,4,8,18,45,48,125
7/7/2010,2,8,33,36,41,44,164
10/7/2010,7,11,27,28,37,40,150
11/7/2010,4,21,31,44,51,58,209
14/07/2010,7,18,35,41,43,50,194
17/07/2010,3,4,34,37,38,57,173
18/07/2010,8,16,44,45,46,52,211
21/07/2010,5,9,16,38,42,49,159
24/07/2010,5,19,23,28,47,58,180
25/07/2010,24,33,36,39,42,50,224
27/07/2010,15,23,24,26,37,47,172
28/07/2010,8,21,22,35,41,58,185
31/07/2010,1,2,27,40,54,55,179
1/8/2010,1,7,8,40,46,57,159
3/8/2010,1,21,46,49,51,53,221
4/8/2010,10,19,27,31,34,51,172
7/8/2010,7,12,14,23,31,35,122
8/8/2010,9,11,31,44,48,57,200
11/8/2010,5,8,9,20,52,54,148
14/08/2010,21,23,25,34,43,47,193
15/08/2010,20,21,23,30,31,44,169
18/08/2010,21,23,42,49,55,58,248
21/08/2010,9,12,15,40,46,48,170
22/08/2010,10,25,34,35,47,52,203
25/08/2010,12,14,16,35,45,46,168
28/08/2010,5,15,28,33,38,56,175
29/08/2010,12,30,35,41,43,55,216
1/9/2010,7,20,29,35,36,56,183
4/9/2010,1,3,6,27,44,49,130
5/9/2010,3,6,8,22,26,32,97
8/9/2010,15,38,41,48,49,52,243
11/9/2010,10,16,29,40,44,57,196
12/9/2010,12,17,21,31,33,35,149
15/09/2010,16,24,26,34,36,46,182
18/09/2010,11,17,19,24,40,44,155
19/09/2010,3,7,28,35,48,50,171
22/09/2010,3,11,13,21,53,54,155
25/09/2010,1,3,13,18,20,36,91
26/09/2010,21,23,26,43,44,54,211
28/09/2010,8,11,19,22,54,55,169
29/09/2010,11,22,27,30,35,53,178
2/10/2010,4,8,11,13,17,48,101
3/10/2010,2,4,24,26,32,53,141
5/10/2010,6,14,32,42,48,56,198
6/10/2010,6,20,23,32,38,50,169
9/10/2010,4,18,19,27,46,49,163
10/10/2010,2,3,10,24,30,39,108
13/10/2010,17,18,26,30,42,50,183
16/10/2010,3,6,7,9,37,46,108
17/10/2010,13,28,39,40,42,57,219
20/10/2010,8,14,27,35,42,55,181
23/10/2010,7,33,38,44,52,56,230
24/10/2010,7,11,18,19,22,26,103
26/10/2010,11,13,24,33,35,49,165
27/10/2010,2,11,15,36,44,51,159
30/10/2010,7,19,26,30,38,39,159
31/10/2010,3,4,11,29,40,53,140
2/11/2010,1,5,25,29,33,53,146
3/11/2010,9,17,22,29,36,45,158
6/11/2010,13,19,30,35,39,52,188
7/11/2010,20,25,34,47,49,56,231
10/11/2010,14,22,26,29,41,46,178
13/11/2010,5,8,17,21,31,42,124
14/11/2010,19,27,36,38,43,54,217
17/11/2010,5,22,25,43,46,58,199
20/11/2010,9,19,29,41,43,55,196
21/11/2010,10,11,26,31,43,52,173
24/11/2010,5,13,21,26,38,54,157
27/11/2010,23,27,30,49,51,53,233
28/11/2010,13,20,22,32,41,49,177
30/11/2010,4,11,44,49,54,56,218
1/12/2010,23,27,33,41,55,57,236
4/12/2010,4,9,22,25,28,36,124
5/12/2010,14,23,30,35,44,53,199
8/12/2010,3,9,29,35,54,55,185
11/12/2010,5,9,10,18,28,50,120
12/12/2010,4,11,17,21,23,41,117
15/12/2010,1,13,19,20,28,55,136
18/12/2010,9,24,32,34,38,39,176
19/12/2010,16,21,24,29,35,54,179
22/12/2010,10,14,20,31,37,38,150
25/12/2010,1,6,20,32,40,54,153
26/12/2010,11,17,26,40,48,52,194
28/12/2010,5,22,46,55,57,58,243
29/12/2010,18,32,45,50,51,53,249
1/1/2011,8,13,25,26,30,35,137
2/1/2011,11,27,33,37,44,51,203
5/1/2011,16,20,21,27,28,54,166
8/1/2011,10,14,15,16,25,46,126
9/1/2011,1,5,11,13,16,27,73
12/1/2011,4,5,13,20,23,35,100
15/01/2011,16,22,33,35,39,43,188
16/01/2011,4,7,18,31,54,55,169
19/01/2011,9,34,42,48,52,53,238
22/01/2011,9,13,18,28,33,47,148
23/01/2011,6,22,27,30,51,52,188
25/01/2011,16,26,33,35,40,43,193
26/01/2011,3,12,21,22,28,56,142
29/01/2011,1,22,42,48,51,52,216
30/01/2011,7,9,24,25,33,53,151
1/2/2011,12,20,42,50,51,56,231
2/2/2011,2,21,33,38,47,50,191
5/2/2011,1,12,16,26,35,42,132
6/2/2011,19,20,24,38,46,57,204
8/2/2011,8,14,42,44,49,55,212
9/2/2011,14,26,33,44,47,58,222
12/2/2011,12,24,39,47,48,50,220
13/02/2011,5,7,10,26,29,51,128
16/02/2011,1,10,11,36,41,51,150
19/02/2011,18,37,38,42,53,54,242
20/02/2011,2,3,15,42,48,57,167
22/02/2011,1,11,15,29,45,47,148
23/02/2011,5,6,20,23,26,34,114
26/02/2011,11,15,18,25,47,51,167
27/02/2011,7,13,25,37,44,51,177
1/3/2011,20,23,27,40,45,51,206
2/3/2011,2,3,8,12,39,44,108
5/3/2011,25,39,40,46,47,55,252
6/3/2011,1,13,14,20,23,53,124
9/3/2011,10,18,22,26,30,57,163
12/3/2011,5,11,34,36,49,57,192
13/03/2011,10,11,17,19,23,39,119
16/03/2011,4,5,17,19,43,44,132
19/03/2011,14,17,33,40,43,54,201
20/03/2011,2,10,15,20,27,39,113
23/03/2011,11,21,30,31,45,56,194
26/03/2011,26,30,35,38,41,44,214
27/03/2011,9,17,26,29,37,58,176
29/03/2011,4,5,9,20,39,53,130
30/03/2011,7,26,44,46,48,49,220
2/4/2011,4,8,14,35,53,58,172
3/4/2011,5,10,12,18,19,28,92
5/4/2011,3,6,10,32,40,41,132
6/4/2011,6,12,34,44,47,53,196
9/4/2011,9,25,28,33,37,43,175
10/4/2011,6,21,26,43,50,52,198
13/04/2011,5,8,13,23,41,50,140
16/04/2011,8,19,23,28,31,56,165
17/04/2011,5,12,16,25,56,57,171
20/04/2011,6,22,25,26,35,37,151
23/04/2011,1,9,20,21,29,32,112
24/04/2011,10,14,27,40,44,55,190
26/04/2011,1,2,7,8,30,34,82
27/04/2011,10,15,23,40,42,51,181
30/04/2011,6,14,26,33,51,55,185
1/5/2011,3,29,31,44,48,57,212
3/5/2011,20,31,37,42,45,47,222
4/5/2011,6,11,24,29,46,47,163
7/5/2011,1,3,17,18,23,37,99
8/5/2011,2,5,44,49,53,55,208
11/5/2011,5,23,27,39,49,50,193
14/05/2011,11,17,24,45,46,52,195
15/05/2011,1,4,15,23,36,41,120
18/05/2011,18,28,30,46,48,49,219
21/05/2011,4,11,26,30,42,45,158
22/05/2011,6,9,19,27,47,55,163
25/05/2011,17,23,31,35,48,53,207
28/05/2011,16,26,39,44,46,51,222
29/05/2011,7,9,27,28,47,54,172
31/05/2011,1,3,20,36,45,48,153
1/6/2011,1,18,28,41,48,52,188
4/6/2011,1,5,23,25,30,55,139
5/6/2011,3,8,27,30,43,58,169
8/6/2011,1,6,8,42,51,53,161
11/6/2011,1,24,34,37,38,58,192
12/6/2011,2,5,24,49,53,55,188
15/06/2011,5,7,11,20,37,44,124
18/06/2011,1,2,34,45,46,58,186
19/06/2011,6,18,21,26,27,29,127
22/06/2011,18,23,24,38,44,50,197
25/06/2011,2,10,35,36,45,52,180
26/06/2011,8,11,14,27,39,50,149
28/06/2011,5,8,21,39,43,58,174
29/06/2011,3,14,16,19,24,40,116
2/7/2011,16,22,23,28,30,42,161
3/7/2011,1,15,18,19,23,44,120
5/7/2011,3,4,31,32,40,49,159
6/7/2011,3,11,34,35,43,48,174
9/7/2011,5,17,21,37,48,52,180
10/7/2011,1,25,26,43,50,54,199
13/07/2011,2,14,23,26,32,33,130
16/07/2011,12,14,33,40,42,51,192
17/07/2011,5,7,16,24,25,41,118
20/07/2011,1,29,30,32,46,57,195
23/07/2011,15,20,21,38,42,55,191
24/07/2011,11,17,23,41,42,46,180
27/07/2011,17,26,36,37,43,53,212
30/07/2011,10,15,34,37,40,46,182
31/07/2011,12,18,27,34,41,49,181
3/8/2011,18,20,49,52,53,57,249
6/8/2011,7,22,34,45,49,57,214
7/8/2011,3,25,31,32,41,42,174
10/8/2011,3,16,24,29,53,55,180
13/08/2011,2,3,4,6,13,35,63
14/08/2011,3,4,11,17,27,44,106
17/08/2011,18,23,30,32,45,53,201
20/08/2011,2,23,31,32,44,55,187
21/08/2011,4,10,20,30,43,46,153
24/08/2011,8,27,28,29,40,48,180
27/08/2011,2,3,14,21,25,45,110
28/08/2011,8,15,22,28,36,55,164
31/08/2011,9,14,18,37,49,52,179
3/9/2011,23,29,31,35,37,46,201
4/9/2011,7,16,40,41,50,53,207
6/9/2011,14,23,34,43,53,55,222
7/9/2011,28,37,43,48,51,56,263
10/9/2011,7,8,12,14,40,43,124
11/9/2011,21,34,38,42,45,46,226
14/09/2011,34,40,50,53,55,58,290
17/09/2011,10,14,23,30,36,48,161
18/09/2011,7,17,28,30,36,44,162
21/09/2011,9,18,21,39,50,58,195
24/09/2011,8,29,37,40,42,53,209
25/09/2011,6,7,13,42,46,54,168
27/09/2011,27,33,34,45,47,56,242
28/09/2011,11,29,39,44,56,57,236
1/10/2011,2,13,17,27,33,53,145
2/10/2011,3,21,30,31,39,55,179
4/10/2011,27,35,36,37,38,49,222
5/10/2011,4,12,13,27,33,58,147
8/10/2011,1,2,6,8,28,58,103
9/10/2011,15,30,33,36,38,41,193
12/10/2011,7,33,35,36,43,49,203
15/10/2011,5,10,12,22,25,37,111
16/10/2011,5,8,24,33,44,47,161
19/10/2011,5,9,11,34,43,44,146
22/10/2011,16,17,19,21,38,57,168
23/10/2011,11,14,16,23,49,58,171
25/10/2011,21,26,36,41,44,45,213
26/10/2011,12,21,23,27,29,44,156
29/10/2011,9,13,19,26,35,40,142
30/10/2011,1,3,17,31,35,39,126
1/11/2011,12,17,28,42,50,57,206
2/11/2011,5,25,28,36,39,42,175
5/11/2011,13,26,34,38,39,44,194
6/11/2011,12,15,21,28,42,58,176
9/11/2011,11,18,19,24,56,58,186
12/11/2011,20,27,35,36,43,57,218
13/11/2011,2,7,13,20,39,48,129
16/11/2011,2,3,12,16,34,35,102
19/11/2011,17,36,39,40,41,44,217
20/11/2011,1,9,11,20,24,54,119
23/11/2011,11,15,22,37,38,42,165
26/11/2011,2,7,10,14,24,35,92
27/11/2011,2,20,25,26,29,53,155
29/11/2011,6,17,31,42,43,48,187
30/11/2011,5,23,26,29,31,58,172
3/12/2011,3,7,15,20,45,53,143
4/12/2011,4,24,27,31,49,57,192
6/12/2011,15,32,36,45,55,58,241
7/12/2011,3,28,43,46,56,57,233
10/12/2011,6,8,9,11,23,56,113
11/12/2011,6,16,20,21,39,52,154
14/12/2011,7,16,21,40,41,43,168
17/12/2011,5,13,26,34,49,51,178
18/12/2011,9,19,29,41,54,58,210
21/12/2011,5,13,38,47,50,51,204
24/12/2011,17,36,43,44,45,51,236
25/12/2011,4,5,21,47,51,52,180
27/12/2011,3,12,25,27,42,52,161
28/12/2011,6,8,22,25,30,57,148
31/12/2011,5,17,20,46,55,58,201
1/1/2012,7,15,16,19,24,51,132
4/1/2012,18,21,42,44,48,56,229
7/1/2012,4,29,39,41,43,52,208
8/1/2012,13,15,16,18,43,45,150
11/1/2012,5,9,13,17,35,41,120
14/01/2012,3,13,30,31,34,52,163
15/01/2012,2,7,10,17,23,29,88
17/01/2012,1,7,19,37,46,55,165
18/01/2012,2,12,24,25,32,33,128
21/01/2012,9,26,32,34,51,57,209
22/01/2012,7,25,26,35,43,50,186
24/01/2012,11,13,24,39,44,54,185
25/01/2012,4,12,36,38,46,50,186
28/01/2012,9,19,30,31,35,38,162
29/01/2012,3,12,30,32,36,47,160
31/01/2012,11,13,14,37,42,51,168
1/2/2012,7,38,39,48,57,58,247
4/2/2012,3,10,15,16,28,53,125
5/2/2012,8,17,24,49,54,57,209
8/2/2012,6,11,43,49,55,58,222
11/2/2012,7,21,24,25,52,57,186
12/2/2012,9,15,28,34,36,56,178
14/02/2012,10,17,38,39,50,58,212
15/02/2012,21,29,30,35,46,58,219
18/02/2012,1,11,19,20,43,58,152
19/02/2012,10,11,16,36,39,56,168
22/02/2012,8,17,23,25,28,42,143
25/02/2012,10,17,19,24,53,56,179
26/02/2012,18,19,37,42,51,53,220
28/02/2012,3,20,50,53,55,57,238
29/02/2012,11,21,22,51,53,54,212
3/3/2012,1,4,26,41,44,50,166
4/3/2012,3,9,20,29,41,58,160
7/3/2012,1,24,31,38,43,45,182
10/3/2012,1,26,35,37,47,58,204
11/3/2012,11,15,24,42,53,58,203
14/03/2012,9,15,22,31,40,49,166
17/03/2012,13,20,31,36,50,54,204
18/03/2012,4,16,21,26,31,50,148
20/03/2012,10,19,25,40,42,54,190
21/03/2012,5,19,31,50,54,57,216
24/03/2012,14,24,40,42,43,57,220
25/03/2012,9,18,22,28,38,39,154
28/03/2012,14,18,20,44,47,48,191
31/03/2012,14,18,30,33,47,52,194
1/4/2012,3,20,48,52,56,57,236
3/4/2012,10,12,24,27,36,38,147
4/4/2012,2,3,20,28,42,48,143
7/4/2012,7,17,25,38,48,50,185
8/4/2012,11,14,30,35,46,55,191
11/4/2012,3,9,22,25,34,35,128
14/04/2012,9,19,27,38,45,46,184
15/04/2012,16,18,46,51,54,57,242
17/04/2012,2,9,10,28,35,36,120
18/04/2012,6,9,17,18,26,47,123
21/04/2012,10,37,44,45,51,54,241
22/04/2012,3,8,19,20,33,40,123
25/04/2012,12,19,23,39,40,53,186
28/04/2012,8,11,15,20,33,34,121
29/04/2012,15,26,39,40,52,54,226
2/5/2012,4,26,36,41,45,52,204
5/5/2012,28,38,40,46,52,53,257
6/5/2012,5,7,16,23,26,39,116
8/5/2012,16,22,23,26,31,58,176
9/5/2012,17,32,41,42,44,58,234
12/5/2012,10,13,16,26,36,56,157
13/05/2012,4,7,10,38,50,57,166
16/05/2012,2,10,25,28,31,36,132
19/05/2012,14,21,30,31,48,51,195
20/05/2012,9,14,17,19,26,52,137
23/05/2012,8,11,20,49,57,58,203
26/05/2012,15,17,18,31,49,55,185
27/05/2012,4,20,45,49,50,58,226
29/05/2012,4,5,24,25,31,34,123
30/05/2012,7,9,33,36,40,56,181
2/6/2012,20,24,25,32,50,52,203
3/6/2012,10,19,21,34,42,45,171
6/6/2012,13,20,22,23,52,58,188
9/6/2012,30,41,45,46,47,58,267
10/6/2012,5,27,29,41,43,51,196
13/06/2012,3,23,25,48,51,57,207
16/06/2012,5,26,30,40,51,57,209
17/06/2012,7,12,18,30,41,44,152
20/06/2012,8,30,35,38,46,50,207
23/06/2012,2,19,21,30,41,42,155
24/06/2012,15,25,28,29,35,37,169
26/06/2012,13,16,19,30,32,56,166
27/06/2012,6,12,39,42,53,58,210
30/06/2012,2,7,12,25,29,33,108
1/7/2012,7,14,43,45,46,53,208
3/7/2012,17,23,37,39,44,46,206
4/7/2012,1,2,20,34,50,54,161
7/7/2012,11,12,24,25,36,53,161
8/7/2012,18,20,30,45,57,58,228
11/7/2012,9,11,18,20,21,50,129
14/07/2012,3,5,14,27,31,40,120
15/07/2012,2,6,14,32,34,50,138
17/07/2012,6,12,20,33,40,56,167
18/07/2012,3,4,14,21,31,54,127
21/07/2012,12,20,25,26,27,56,166
22/07/2012,15,28,46,49,53,57,248
25/07/2012,25,32,33,40,51,57,238
28/07/2012,2,27,46,49,50,57,231
29/07/2012,25,31,32,41,51,53,233
1/8/2012,4,5,28,38,43,56,174
4/8/2012,11,17,22,32,50,51,183
5/8/2012,1,10,14,27,41,47,140
8/8/2012,20,22,34,35,39,48,198
11/8/2012,4,9,11,13,44,46,127
12/8/2012,14,31,33,42,47,58,225
15/08/2012,9,26,32,33,35,36,171
18/08/2012,1,8,11,12,40,49,121
19/08/2012,5,13,17,19,32,52,138
22/08/2012,18,22,24,37,38,48,187
25/08/2012,2,15,17,31,37,41,143
26/08/2012,19,20,27,34,37,58,195
28/08/2012,19,20,30,31,35,38,173
29/08/2012,2,8,34,36,41,47,168
1/9/2012,7,12,14,20,21,29,103
2/9/2012,1,9,32,35,37,45,159
4/9/2012,3,14,20,28,30,43,138
5/9/2012,1,20,26,33,49,55,184
8/9/2012,12,22,42,44,48,51,219
9/9/2012,7,13,20,34,35,43,152
12/9/2012,7,9,11,13,46,57,143
15/09/2012,8,22,25,36,57,58,206
16/09/2012,2,8,21,32,34,53,150
18/09/2012,5,29,40,44,51,58,227
19/09/2012,4,10,20,21,52,55,162
22/09/2012,12,16,35,40,41,58,202
23/09/2012,22,32,38,39,45,57,233
26/09/2012,9,13,16,18,33,54,143
29/09/2012,2,13,19,30,50,51,165
30/09/2012,2,14,22,23,25,43,129
2/10/2012,3,9,11,12,47,57,139
3/10/2012,10,22,30,31,32,52,177
6/10/2012,1,5,11,13,16,53,99
7/10/2012,6,11,13,21,46,51,148
10/10/2012,7,16,26,37,38,49,173
13/10/2012,10,15,16,21,31,45,138
14/10/2012,2,16,34,39,49,56,196
17/10/2012,5,6,8,40,41,47,147
20/10/2012,6,20,48,50,51,56,231
21/10/2012,11,19,32,52,53,56,223
24/10/2012,16,19,20,21,39,58,173
27/10/2012,3,26,27,28,32,57,173
28/10/2012,4,26,33,36,40,42,181
30/10/2012,1,4,8,20,29,42,104
31/10/2012,3,4,23,46,49,53,178
3/11/2012,2,11,17,20,29,58,137
4/11/2012,29,42,43,45,49,51,259
7/11/2012,6,23,26,40,41,57,193
10/11/2012,8,10,16,20,49,57,160
11/11/2012,1,9,17,39,51,58,175
13/11/2012,6,20,28,29,31,42,156
14/11/2012,7,13,37,45,52,57,211
17/11/2012,1,9,14,26,41,52,143
18/11/2012,2,3,14,19,32,36,106
21/11/2012,3,25,39,40,55,56,218
24/11/2012,18,25,27,29,36,54,189
25/11/2012,21,30,52,53,56,57,269
27/11/2012,4,15,22,24,43,49,157
28/11/2012,8,14,41,45,48,51,207
1/12/2012,13,23,34,46,53,55,224
2/12/2012,4,15,23,32,47,58,179
4/12/2012,4,8,28,33,46,47,166
5/12/2012,1,7,10,36,44,46,144
8/12/2012,1,8,24,44,46,48,171
9/12/2012,3,5,6,18,22,39,93
12/12/2012,1,9,27,45,50,53,185
15/12/2012,5,6,15,35,39,40,140
16/12/2012,7,11,39,47,49,58,211
18/12/2012,6,10,12,48,49,57,182
19/12/2012,9,10,17,37,42,56,171
22/12/2012,13,14,21,27,34,44,153
23/12/2012,20,38,44,46,50,55,253
26/12/2012,7,33,36,40,46,50,212
29/12/2012,5,6,16,21,51,57,156
30/12/2012,11,20,30,31,33,48,173
2/1/2013,11,12,20,22,28,46,139
5/1/2013,13,24,29,32,38,46,182
6/1/2013,3,19,27,32,52,53,186
8/1/2013,4,10,13,15,37,51,130
9/1/2013,6,15,26,44,47,52,190
12/1/2013,1,9,27,40,48,58,183
13/01/2013,5,8,20,41,53,58,185
16/01/2013,3,20,22,26,27,33,131
19/01/2013,1,21,29,35,42,55,183
20/01/2013,3,9,20,38,40,58,168
22/01/2013,6,14,23,29,47,53,172
23/01/2013,7,18,28,29,31,42,155
26/01/2013,1,6,23,32,35,57,154
27/01/2013,1,3,20,21,25,33,103
30/01/2013,4,7,12,17,41,46,127
2/2/2013,1,15,39,42,43,45,185
3/2/2013,7,19,27,41,43,56,193
5/2/2013,12,22,34,46,53,55,222
6/2/2013,3,9,28,30,38,49,157
9/2/2013,12,29,32,46,51,52,222
10/2/2013,1,5,17,21,24,30,98
12/2/2013,17,19,25,31,37,40,169
13/02/2013,5,6,8,21,38,40,118
16/02/2013,27,30,37,43,48,49,234
17/02/2013,13,25,26,27,29,50,170
19/02/2013,6,17,29,39,41,46,178
20/02/2013,21,30,31,41,44,52,219
23/02/2013,20,24,27,28,37,54,190
24/02/2013,7,17,33,34,35,45,171
27/02/2013,1,3,5,21,30,38,98
2/3/2013,2,37,42,45,47,57,230
3/3/2013,23,27,33,45,49,55,232
5/3/2013,1,2,41,48,57,58,207
6/3/2013,12,14,31,34,37,43,171
9/3/2013,1,36,43,46,48,52,226
10/3/2013,6,7,22,30,34,43,142
13/03/2013,9,15,30,31,38,52,175
16/03/2013,4,19,24,42,49,53,191
17/03/2013,13,23,28,36,37,46,183
20/03/2013,17,18,27,42,45,48,197
23/03/2013,2,12,37,54,56,57,218
24/03/2013,2,16,21,31,41,46,157
26/03/2013,23,24,30,50,55,56,238
27/03/2013,2,3,9,30,31,32,107
30/03/2013,32,34,40,47,48,49,250
31/03/2013,20,32,39,41,52,53,237
2/4/2013,3,5,15,35,36,44,138
3/4/2013,11,14,18,19,44,51,157
6/4/2013,11,16,27,38,50,54,196
7/4/2013,11,18,21,25,47,58,180
10/4/2013,14,20,27,31,36,48,176
13/04/2013,2,27,31,38,54,55,207
14/04/2013,4,9,23,26,42,47,151
17/04/2013,5,22,35,42,43,56,203
20/04/2013,26,31,33,45,51,56,242
21/04/2013,1,21,25,38,41,52,178
24/04/2013,12,30,32,37,41,47,199
27/04/2013,22,23,35,40,46,56,222
28/04/2013,2,8,15,48,50,54,177
30/04/2013,5,27,41,45,50,54,222
1/5/2013,9,16,23,30,42,47,167
4/5/2013,10,19,21,33,40,57,180
5/5/2013,18,20,23,25,37,45,168
7/5/2013,5,23,24,29,39,43,163
8/5/2013,11,24,33,34,51,58,211
11/5/2013,6,20,23,25,34,44,152
12/5/2013,17,36,37,44,46,47,227
15/05/2013,13,30,42,44,49,52,230
18/05/2013,3,6,25,29,34,48,145
19/05/2013,19,37,40,45,48,49,238
22/05/2013,2,4,10,33,37,54,140
25/05/2013,17,29,34,53,55,57,245
26/05/2013,10,19,42,43,53,56,223
28/05/2013,8,16,20,43,48,54,189
29/05/2013,22,26,38,42,43,49,220
1/6/2013,12,15,20,29,37,52,165
2/6/2013,14,22,24,31,35,55,181
5/6/2013,1,7,9,33,37,48,135
8/6/2013,8,10,12,23,49,54,156
9/6/2013,1,10,25,29,36,50,151
12/6/2013,18,29,32,34,51,52,216
15/06/2013,4,14,25,48,51,58,200
16/06/2013,9,28,32,43,48,50,210
19/06/2013,1,5,6,17,20,23,72
22/06/2013,14,24,30,34,40,54,196
23/06/2013,14,25,32,44,56,57,228
25/06/2013,4,13,14,15,27,57,130
26/06/2013,5,10,14,18,24,55,126
29/06/2013,18,19,36,38,44,58,213
30/06/2013,5,9,15,38,56,57,180
2/7/2013,17,20,29,34,40,48,188
3/7/2013,2,25,26,33,35,36,157
6/7/2013,8,12,15,16,36,48,135
7/7/2013,14,34,37,44,46,52,227
10/7/2013,3,7,15,19,23,52,119
13/07/2013,9,20,21,25,31,50,156
14/07/2013,4,10,24,30,35,45,148
17/07/2013,19,21,40,43,52,58,233
20/07/2013,5,20,44,53,54,57,233
21/07/2013,8,15,19,32,34,37,145
24/07/2013,7,16,34,42,49,53,201
27/07/2013,11,14,23,41,47,49,185
28/07/2013,7,18,23,41,47,56,192
31/07/2013,4,7,14,31,39,51,146
3/8/2013,1,5,7,14,40,44,111
4/8/2013,3,15,21,34,47,56,176
7/8/2013,2,5,16,34,46,55,158
10/8/2013,1,3,5,29,44,48,130
11/8/2013,9,24,33,37,42,48,193
13/08/2013,2,9,11,36,41,57,156
14/08/2013,17,20,38,44,49,54,222
17/08/2013,13,23,41,48,49,57,231
18/08/2013,10,16,43,46,51,57,223
21/08/2013,2,17,30,34,39,57,179
24/08/2013,13,25,27,29,32,37,163
25/08/2013,7,26,38,42,45,52,210
27/08/2013,11,31,42,52,53,58,247
28/08/2013,6,15,16,20,39,57,153
31/08/2013,6,11,24,43,46,55,185
1/9/2013,7,23,32,34,49,51,196
3/9/2013,12,14,15,23,26,41,131
4/9/2013,5,9,12,14,15,16,71
7/9/2013,1,21,36,37,40,44,179
8/9/2013,3,17,21,29,47,55,172
11/9/2013,2,8,19,22,26,32,109
14/09/2013,3,18,20,37,54,58,190
15/09/2013,1,13,24,26,32,44,140
18/09/2013,16,27,36,43,55,56,233
21/09/2013,4,14,15,24,42,49,148
22/09/2013,12,14,19,27,46,47,165
25/09/2013,7,11,12,22,26,28,106
28/09/2013,4,9,13,15,45,58,144
29/09/2013,21,24,32,33,56,58,224
1/10/2013,11,14,26,32,41,56,180
2/10/2013,5,8,12,36,50,57,168
5/10/2013,9,18,30,35,50,54,196
6/10/2013,3,11,15,25,32,58,144
9/10/2013,6,21,35,36,39,48,185
12/10/2013,16,27,31,44,46,54,218
13/10/2013,6,23,26,28,48,57,188
16/10/2013,4,12,23,35,37,44,155
19/10/2013,8,20,28,31,50,52,189
20/10/2013,26,41,43,44,54,58,266
23/10/2013,9,19,30,38,47,57,200
26/10/2013,5,12,21,32,42,51,163
27/10/2013,8,15,22,24,33,58,160
29/10/2013,12,15,22,31,45,57,182
30/10/2013,10,27,28,45,49,52,211
2/11/2013,3,9,30,37,38,50,167
3/11/2013,10,20,36,40,41,57,204
5/11/2013,12,34,42,47,48,52,235
6/11/2013,6,14,19,23,55,56,173
9/11/2013,3,27,28,37,40,42,177
10/11/2013,1,8,22,27,38,40,136
13/11/2013,7,8,16,31,50,56,168
16/11/2013,8,18,19,28,30,31,134
17/11/2013,4,5,15,21,43,51,139
20/11/2013,20,31,41,43,49,50,234
23/11/2013,5,7,17,28,43,54,154
24/11/2013,10,15,16,36,42,55,174
26/11/2013,22,27,33,36,38,56,212
27/11/2013,16,21,34,37,42,50,200
30/11/2013,4,13,25,35,36,43,156
1/12/2013,5,8,15,30,48,54,160
3/12/2013,7,8,25,31,49,53,173
4/12/2013,5,7,12,16,32,44,116
7/12/2013,1,8,9,33,36,45,132
8/12/2013,9,14,24,25,31,56,159
11/12/2013,2,8,33,40,53,58,194
14/12/2013,6,19,20,37,53,55,190
15/12/2013,36,39,47,48,49,58,277
18/12/2013,12,16,27,42,45,54,196
21/12/2013,12,17,24,29,39,51,172
22/12/2013,22,32,35,38,45,51,223
25/12/2013,13,28,40,49,53,56,239
28/12/2013,5,12,21,37,40,56,171
29/12/2013,9,10,11,17,35,57,139
31/12/2013,3,11,19,34,36,53,156
1/1/2014,1,32,38,41,48,52,212
4/1/2014,3,5,21,24,27,41,121
5/1/2014,16,24,33,37,41,45,196
7/1/2014,3,19,20,22,41,47,152
8/1/2014,12,13,14,15,38,45,137
11/1/2014,1,11,37,41,43,48,181
12/1/2014,20,32,35,44,47,48,226
15/01/2014,5,8,20,25,49,50,157
18/01/2014,3,16,21,40,44,54,178
19/01/2014,4,6,10,13,48,56,137
22/01/2014,19,20,25,41,50,54,209
25/01/2014,3,14,22,25,30,50,144
26/01/2014,2,9,28,33,44,54,170
28/01/2014,14,18,21,28,35,47,163
29/01/2014,2,21,24,29,37,55,168
1/2/2014,3,10,13,14,22,25,87
2/2/2014,30,33,39,42,51,52,247
4/2/2014,11,15,30,41,54,55,206
5/2/2014,9,10,11,18,25,58,131
8/2/2014,24,25,32,35,40,56,212
9/2/2014,4,8,10,26,52,58,158
11/2/2014,10,15,22,34,51,53,185
12/2/2014,18,19,34,36,44,48,199
15/02/2014,1,8,27,42,43,45,166
16/02/2014,1,5,18,19,25,55,123
19/02/2014,9,15,23,42,46,55,190
22/02/2014,2,10,17,26,37,38,130
23/02/2014,2,11,16,34,43,57,163
25/02/2014,7,8,11,34,57,58,175
26/02/2014,11,17,22,30,35,38,153
1/3/2014,2,8,31,35,42,52,170
2/3/2014,8,9,19,31,34,42,143
4/3/2014,9,14,24,29,36,44,156
5/3/2014,10,14,15,16,40,43,138
8/3/2014,8,16,21,29,37,53,164
9/3/2014,1,8,10,31,34,37,121
12/3/2014,4,24,32,36,42,55,193
15/03/2014,10,24,31,50,56,57,228
16/03/2014,6,16,18,32,33,55,160
19/03/2014,9,11,16,20,43,44,143
22/03/2014,17,20,24,27,33,52,173
23/03/2014,6,15,26,34,37,43,161
25/03/2014,8,10,20,28,53,58,177
26/03/2014,3,22,28,31,40,55,179
29/03/2014,27,32,33,37,39,47,215
30/03/2014,4,32,44,49,52,55,236
2/4/2014,11,16,20,43,46,54,190
5/4/2014,1,6,20,26,50,53,156
6/4/2014,10,32,36,43,47,56,224
8/4/2014,6,14,42,45,50,58,215
9/4/2014,22,25,38,45,49,51,230
12/4/2014,8,9,21,26,31,37,132
13/04/2014,10,14,21,32,52,57,186
16/04/2014,15,26,32,40,47,54,214
19/04/2014,5,12,38,54,55,58,222
20/04/2014,1,4,6,11,25,30,77
23/04/2014,8,14,22,45,46,52,187
26/04/2014,14,17,27,31,37,43,169
27/04/2014,20,23,32,35,40,41,191
29/04/2014,7,10,16,36,51,57,177
30/04/2014,3,27,29,39,40,54,192
3/5/2014,1,8,16,35,41,43,144
4/5/2014,3,5,12,29,35,40,124
6/5/2014,4,7,18,32,40,41,142
7/5/2014,3,11,16,25,38,56,149
10/5/2014,17,23,38,42,43,49,212
11/5/2014,6,13,23,37,46,51,176
14/05/2014,10,25,39,45,52,55,226
17/05/2014,3,10,35,38,53,54,193
18/05/2014,13,24,42,49,53,55,236
21/05/2014,8,29,37,39,45,48,206
24/05/2014,16,20,22,24,28,34,144
25/05/2014,1,2,5,18,21,41,88
28/05/2014,20,23,27,50,55,56,231
31/05/2014,4,18,19,42,43,53,179
1/6/2014,6,12,16,28,37,42,141
3/6/2014,7,9,21,35,44,52,168
4/6/2014,8,16,18,29,37,40,148
7/6/2014,14,16,20,44,57,58,209
8/6/2014,1,24,30,36,47,49,187
11/6/2014,28,30,31,35,36,47,207
14/06/2014,17,19,20,32,50,53,191
15/06/2014,5,7,15,22,31,55,135
18/06/2014,12,26,31,41,51,52,213
21/06/2014,3,6,21,39,52,54,175
22/06/2014,7,19,20,26,37,54,163
24/06/2014,5,9,17,28,32,48,139
25/06/2014,21,24,26,30,45,57,203
28/06/2014,15,42,49,54,55,56,271
29/06/2014,4,9,10,11,49,52,135
2/7/2014,22,23,30,31,41,43,190
5/7/2014,10,19,27,29,34,48,167
6/7/2014,1,7,15,29,36,37,125
9/7/2014,12,21,25,37,39,58,192
12/7/2014,12,26,35,37,39,46,195
13/07/2014,1,20,25,26,42,44,158
16/07/2014,11,20,29,39,49,58,206
19/07/2014,2,15,35,44,53,54,203
20/07/2014,19,29,37,46,51,54,236
23/07/2014,15,22,23,29,34,44,167
26/07/2014,6,15,16,31,38,44,150
27/07/2014,4,6,29,33,36,45,153
30/07/2014,25,32,44,52,54,58,265
3/8/2014,2,7,10,22,38,54,133
5/8/2014,9,12,18,19,20,51,129
9/8/2014,10,18,30,50,56,57,221
10/8/2014,4,7,24,34,40,48,157
13/08/2014,1,15,42,44,49,54,205
16/08/2014,14,25,28,42,48,55,212
17/08/2014,21,34,36,47,50,53,241
20/08/2014,9,17,21,30,39,42,158
23/08/2014,29,30,36,42,46,53,236
24/08/2014,8,11,13,31,33,54,150
26/08/2014,11,24,31,38,40,53,197
27/08/2014,12,13,15,24,29,31,124
30/08/2014,2,20,45,49,54,55,225
31/08/2014,15,17,19,39,51,52,193
2/9/2014,5,22,24,26,42,46,165
3/9/2014,1,8,34,39,46,55,183
6/9/2014,4,15,39,44,51,57,210
10/9/2014,5,21,23,33,42,55,179
13/09/2014,2,5,7,21,44,48,127
14/09/2014,12,14,15,21,36,47,145
17/09/2014,1,2,14,33,37,46,133
20/09/2014,19,23,31,33,51,54,211
21/09/2014,3,4,10,13,46,57,133
24/09/2014,1,15,25,37,48,56,182
27/09/2014,2,19,31,39,46,49,186
28/09/2014,2,3,26,35,45,48,159
30/09/2014,2,6,11,17,47,49,132
5/10/2014,4,6,13,14,26,55,118
8/10/2014,2,18,27,29,47,57,180
11/10/2014,20,22,27,30,49,54,202
12/10/2014,20,23,28,39,41,47,198
15/10/2014,1,17,21,24,48,54,165
18/10/2014,6,15,44,45,54,58,222
22/10/2014,13,16,20,22,29,40,140
25/10/2014,2,6,10,16,24,54,112
26/10/2014,36,37,44,46,55,58,276
28/10/2014,12,17,20,26,36,46,157
1/11/2014,5,15,30,34,39,51,174
5/11/2014,7,10,19,28,41,42,147
8/11/2014,13,17,20,33,34,39,156
9/11/2014,5,6,21,27,33,51,143
12/11/2014,17,24,31,37,43,53,205
16/11/2014,20,27,32,39,54,57,229
19/11/2014,9,13,21,24,36,53,156
22/11/2014,11,12,21,33,47,50,174
23/11/2014,15,17,18,49,52,58,209
25/11/2014,17,18,24,42,47,50,198
26/11/2014,6,10,42,46,49,54,207
29/11/2014,4,15,17,27,29,44,136
2/12/2014,12,14,20,31,38,47,162
3/12/2014,22,31,38,42,45,50,228
13/12/2014,2,12,29,31,34,55,163
14/12/2014,7,23,30,32,49,55,196
17/12/2014,8,24,26,32,46,48,184
21/12/2014,2,11,22,44,49,54,182
27/12/2014,1,8,16,20,38,39,122
28/12/2014,11,19,24,30,37,41,162
30/12/2014,11,23,25,46,49,54,208
31/12/2014,4,12,25,38,40,49,168
4/1/2015,6,12,14,18,33,57,140
11/1/2015,6,12,23,46,48,56,191
14/01/2015,6,8,26,45,47,51,183
17/01/2015,8,10,12,34,47,49,160
24/01/2015,5,10,21,23,29,54,142
25/01/2015,12,13,15,22,24,46,132
27/01/2015,14,16,17,24,39,57,167
1/2/2015,12,24,25,51,52,57,221
14/02/2015,9,13,21,28,29,34,134
15/02/2015,25,35,39,43,45,48,235
18/02/2015,10,13,36,40,50,56,205
28/02/2015,19,28,38,43,53,55,236
1/3/2015,14,30,41,49,54,58,246
3/3/2015,18,22,36,48,54,55,233
4/3/2015,4,7,9,20,30,39,109
8/3/2015,2,9,24,31,49,53,168
14/03/2015,5,10,19,24,26,33,117
15/03/2015,7,12,13,24,32,57,145
18/03/2015,14,16,18,32,48,54,182
25/03/2015,10,15,26,41,53,55,200
28/03/2015,13,14,15,32,47,54,175
29/03/2015,2,19,24,27,39,49,160
31/03/2015,1,4,10,21,48,54,138
1/4/2015,12,14,22,27,31,46,152
8/4/2015,14,20,31,40,50,56,211
11/4/2015,8,35,38,48,49,58,236
15/04/2015,6,13,18,24,35,50,146
18/04/2015,1,42,48,53,57,58,259
25/04/2015,9,11,25,26,29,45,145
29/04/2015,4,5,6,29,32,44,120
9/5/2015,19,29,32,35,43,48,206
10/5/2015,20,35,36,39,45,53,228
17/05/2015,21,24,25,28,31,51,180
23/05/2015,25,42,44,48,50,54,263
24/05/2015,2,19,25,53,57,58,214
26/05/2015,3,4,23,33,35,58,156
27/05/2015,15,17,19,27,36,46,160
30/05/2015,6,19,25,39,46,58,193
3/6/2015,5,16,23,28,55,57,184
10/6/2015,3,7,19,30,42,49,150
13/06/2015,1,11,22,31,36,40,141
14/06/2015,8,13,20,31,35,44,151
17/06/2015,17,27,36,43,46,47,216
20/06/2015,2,4,11,31,45,53,146
28/06/2015,3,8,24,25,26,41,127
1/7/2015,2,7,16,23,48,54,150
8/7/2015,27,30,42,51,54,58,262
11/7/2015,1,7,9,20,27,57,121
12/7/2015,11,20,27,37,46,48,189
15/07/2015,2,10,19,30,32,38,131
28/07/2015,1,12,16,24,52,53,158
29/07/2015,2,32,33,40,46,55,208
4/8/2015,7,11,14,19,47,51,149
15/08/2015,1,7,12,28,35,40,123
16/08/2015,16,19,21,23,25,57,161
19/08/2015,27,30,34,39,47,48,225
29/08/2015,6,12,15,34,37,44,148
1/9/2015,7,9,20,30,37,38,141
2/9/2015,12,14,46,51,52,57,232
12/9/2015,11,20,29,35,37,39,171
13/09/2015,1,35,40,46,52,54,228
16/09/2015,1,9,23,32,44,55,164
19/09/2015,1,24,37,44,49,57,212
29/09/2015,9,28,29,34,37,38,175
30/09/2015,8,10,24,30,36,44,152
4/10/2015,19,25,33,49,55,57,238
7/10/2015,11,15,29,49,52,55,211
11/10/2015,24,45,46,51,54,55,275
14/10/2015,10,22,27,38,43,53,193
18/10/2015,14,18,31,41,44,57,205
1/11/2015,3,15,37,50,55,56,216
3/11/2015,3,15,17,23,25,27,110
7/11/2015,27,29,34,41,50,52,233
8/11/2015,33,47,49,53,56,57,295
11/11/2015,6,14,18,35,50,54,177
18/11/2015,1,7,12,29,34,41,124
21/11/2015,9,12,37,41,45,47,191
22/11/2015,5,26,28,46,51,53,209
24/11/2015,4,6,24,27,43,49,153
25/11/2015,15,24,27,41,48,58,213
5/12/2015,35,38,41,42,43,52,251
12/12/2015,7,16,22,48,53,56,202
16/12/2015,1,19,32,38,51,58,199
26/12/2015,8,23,31,32,42,45,181
27/12/2015,13,15,20,23,52,57,180
29/12/2015,5,12,21,30,31,46,145
30/12/2015,6,7,31,50,52,55,201
3/1/2016,5,26,27,28,33,51,170
5/1/2016,19,20,23,25,29,54,170
10/1/2016,1,11,14,32,45,55,158
13/01/2016,14,29,39,43,45,47,217
16/01/2016,7,10,24,36,37,45,159
23/01/2016,3,4,25,28,31,57,148
24/01/2016,2,16,33,44,54,56,205
26/01/2016,16,35,36,37,47,53,224
27/01/2016,4,7,10,14,29,34,98
31/01/2016,3,5,26,28,47,50,159
7/2/2016,27,33,36,50,51,57,254
13/02/2016,7,13,16,23,28,29,116
14/02/2016,10,11,24,25,34,44,148
16/02/2016,8,15,31,36,55,56,201
17/02/2016,3,6,13,31,52,54,159
20/02/2016,3,10,21,27,42,50,153
28/02/2016,3,11,15,26,34,37,126
1/3/2016,12,14,15,24,30,44,139
2/3/2016,8,19,25,26,31,35,144
9/3/2016,4,11,33,39,43,44,174
12/3/2016,11,25,28,40,42,45,191
13/03/2016,5,8,35,36,46,47,177
23/03/2016,14,20,21,36,47,58,196
26/03/2016,4,7,20,22,23,26,102
27/03/2016,17,22,26,29,44,50,188
29/03/2016,16,32,33,39,44,54,218
30/03/2016,3,5,11,14,23,56,112
3/4/2016,9,10,32,33,46,58,188
5/4/2016,6,9,17,18,28,53,131
6/4/2016,2,10,37,45,52,54,200
9/4/2016,3,4,27,40,44,51,169
10/4/2016,5,19,31,39,42,44,180
13/04/2016,2,20,24,34,41,51,172
17/04/2016,2,4,6,13,23,33,81
23/04/2016,5,28,34,51,54,55,227
24/04/2016,11,23,27,29,37,55,182
26/04/2016,12,15,16,35,36,46,160
27/04/2016,5,8,15,36,40,52,156
3/5/2016,5,14,24,33,46,57,179
4/5/2016,15,19,36,40,41,51,202
7/5/2016,10,28,31,32,41,52,194
8/5/2016,11,35,37,42,43,56,224
11/5/2016,1,35,36,38,42,58,210
21/05/2016,4,6,8,15,18,34,85
22/05/2016,4,16,49,51,55,56,231
25/05/2016,1,13,28,41,46,54,183
31/05/2016,27,29,30,41,42,53,222
4/6/2016,2,10,15,34,46,54,161
5/6/2016,24,31,47,49,53,58,262
8/6/2016,2,5,11,15,42,46,121
11/6/2016,5,7,39,43,52,57,203
12/6/2016,10,17,19,20,40,42,148
15/06/2016,8,30,36,47,50,52,223
18/06/2016,2,14,33,39,42,52,182
19/06/2016,10,12,23,37,46,55,183
22/06/2016,2,6,9,34,36,51,138
25/06/2016,4,10,11,12,42,48,127
26/06/2016,3,5,13,44,53,54,172
29/06/2016,12,21,27,41,54,55,210
2/7/2016,11,12,30,35,37,51,176
3/7/2016,2,8,14,28,44,49,145
6/7/2016,1,2,4,6,40,46,99
9/7/2016,8,19,26,33,41,43,170
10/7/2016,1,15,33,42,49,53,193
12/7/2016,2,17,19,33,47,56,174
13/07/2016,12,19,21,26,40,57,175
16/07/2016,10,29,36,38,47,49,209
17/07/2016,19,31,36,41,43,49,219
20/07/2016,36,40,45,52,54,58,285
23/07/2016,1,2,10,20,37,57,127
24/07/2016,6,25,29,36,48,58,202
27/07/2016,1,20,23,28,53,58,183
30/07/2016,2,5,12,35,36,41,131
31/07/2016,1,13,18,19,45,53,149
3/8/2016,1,12,37,47,50,52,199
6/8/2016,8,18,19,25,29,33,132
7/8/2016,5,19,33,44,50,57,208
9/8/2016,19,21,22,34,41,56,193
10/8/2016,4,7,11,14,16,44,96
13/08/2016,9,10,25,31,34,55,164
14/08/2016,22,30,37,41,46,48,224
17/08/2016,7,9,10,11,39,50,126
20/08/2016,11,13,16,17,27,46,130
21/08/2016,7,23,28,39,43,58,198
24/08/2016,2,16,26,32,49,58,183
27/08/2016,5,11,16,18,19,34,103
28/08/2016,9,15,16,33,45,49,167
30/08/2016,7,13,16,32,42,53,163
31/08/2016,5,6,21,36,37,43,148
3/9/2016,12,22,25,26,29,39,153
4/9/2016,6,11,13,19,53,58,160
6/9/2016,3,17,30,31,34,36,151
7/9/2016,12,22,24,38,43,48,187
10/9/2016,3,12,18,19,46,51,149
11/9/2016,16,23,31,39,43,55,207
14/09/2016,14,18,24,41,43,45,185
17/09/2016,11,14,34,40,42,51,192
18/09/2016,6,18,21,31,48,54,178
21/09/2016,3,10,16,17,20,25,91
24/09/2016,12,21,22,39,41,54,189
25/09/2016,30,42,43,46,52,58,271
27/09/2016,1,14,35,36,42,50,178
28/09/2016,10,14,15,23,28,47,137
1/10/2016,5,7,16,27,39,58,152
2/10/2016,4,11,14,25,41,51,146
4/10/2016,14,16,26,35,48,49,188
5/10/2016,4,27,28,39,53,58,209
8/10/2016,4,11,12,14,26,31,98
9/10/2016,17,21,23,27,31,37,156
12/10/2016,10,16,30,31,34,46,167
15/10/2016,11,12,16,19,35,41,134
16/10/2016,9,28,46,47,52,54,236
19/10/2016,29,33,37,46,50,54,249
22/10/2016,13,27,28,31,32,58,189
23/10/2016,4,36,39,40,44,47,210
25/10/2016,28,31,35,50,52,58,254
26/10/2016,3,4,12,13,44,51,127
29/10/2016,11,18,26,37,55,58,205
30/10/2016,15,22,28,40,43,52,200
1/11/2016,23,35,40,41,42,48,229
2/11/2016,12,16,35,41,46,48,198
5/11/2016,7,11,15,22,56,57,168
6/11/2016,2,21,39,45,52,57,216
9/11/2016,14,21,38,42,50,56,221
12/11/2016,1,17,23,26,36,55,158
13/11/2016,1,10,21,27,51,57,167
16/11/2016,19,30,40,44,45,50,228
19/11/2016,12,22,34,36,39,50,193
20/11/2016,9,13,24,26,36,53,161
23/11/2016,22,34,40,42,48,52,238
26/11/2016,21,27,30,45,54,58,235
27/11/2016,1,18,27,44,45,46,181
29/11/2016,1,6,15,18,26,27,93
30/11/2016,19,25,28,36,44,49,201
3/12/2016,5,19,23,37,42,55,181
4/12/2016,7,10,34,38,50,52,191
6/12/2016,11,12,17,19,41,53,153
7/12/2016,14,20,37,50,51,52,224
10/12/2016,7,10,12,15,28,57,129
11/12/2016,8,17,21,25,35,50,156
14/12/2016,1,6,26,35,38,43,149
17/12/2016,2,14,22,27,51,52,168
18/12/2016,6,11,17,25,36,52,147
21/12/2016,25,27,33,38,40,50,213
24/12/2016,2,25,33,48,52,57,217
25/12/2016,2,28,37,39,49,50,205
27/12/2016,3,8,26,29,32,36,134
28/12/2016,15,28,32,46,55,56,232
31/12/2016,2,3,9,14,16,23,67
1/1/2017,2,7,14,16,24,45,108
3/1/2017,11,14,25,46,54,58,208
4/1/2017,19,20,23,50,53,54,219
7/1/2017,3,6,19,34,36,47,145
8/1/2017,1,24,26,28,32,53,164
11/1/2017,11,12,15,23,29,51,141
14/01/2017,1,22,36,43,54,58,214
15/01/2017,38,39,45,46,52,58,278
17/01/2017,23,33,48,49,51,58,262
18/01/2017,1,5,8,32,37,49,132
21/01/2017,4,29,37,45,46,50,211
22/01/2017,6,10,29,34,45,52,176
24/01/2017,1,25,26,39,52,55,198
25/01/2017,8,24,33,36,54,56,211
28/01/2017,4,16,26,28,30,31,135
29/01/2017,3,7,11,27,32,57,137
31/01/2017,7,10,17,28,51,57,170
1/2/2017,3,4,18,38,44,52,159
4/2/2017,8,17,33,35,38,55,186
5/2/2017,1,5,16,20,27,54,123
7/2/2017,4,15,18,38,47,53,175
8/2/2017,7,20,41,47,51,58,224
11/2/2017,33,38,39,47,48,53,258
12/2/2017,30,32,50,52,53,55,272
15/02/2017,19,20,21,34,48,57,199
18/02/2017,17,21,36,42,46,51,213
19/02/2017,1,3,22,25,31,53,135
22/02/2017,12,22,32,33,51,53,203
25/02/2017,1,8,10,38,41,55,153
26/02/2017,2,26,27,32,53,54,194
28/02/2017,1,5,13,14,39,51,123
1/3/2017,7,14,34,47,52,55,209
4/3/2017,2,17,36,41,44,51,191
5/3/2017,12,14,15,34,39,49,163
8/3/2017,13,27,29,37,40,55,201
11/3/2017,8,11,13,25,26,35,118
12/3/2017,10,14,19,26,43,45,157
15/03/2017,4,26,27,43,45,56,201
18/03/2017,20,28,41,45,51,53,238
19/03/2017,4,5,13,20,55,56,153
22/03/2017,20,23,25,45,48,57,218
25/03/2017,13,23,25,26,53,58,198
26/03/2017,14,34,45,46,54,55,248
28/03/2017,14,20,33,40,42,51,200
29/03/2017,10,12,21,38,51,55,187
1/4/2017,7,12,20,26,36,51,152
2/4/2017,5,36,40,50,52,53,236
4/4/2017,5,18,20,26,36,49,154
5/4/2017,1,26,27,32,39,58,183
8/4/2017,7,8,14,33,49,58,169
9/4/2017,5,18,21,26,40,44,154
12/4/2017,1,11,24,35,42,49,162
15/04/2017,12,14,16,46,48,57,193
16/04/2017,9,11,25,35,39,51,170
19/04/2017,8,22,23,24,32,58,167
22/04/2017,3,6,7,20,31,41,108
23/04/2017,5,6,26,28,30,49,144
25/04/2017,1,24,26,28,41,53,173
26/04/2017,1,3,4,38,46,50,142
29/04/2017,11,15,32,35,39,41,173
30/04/2017,2,9,22,34,40,47,154
2/5/2017,1,8,16,19,24,36,104
3/5/2017,15,17,21,30,42,47,172
6/5/2017,6,24,27,28,34,48,167
7/5/2017,26,29,31,53,56,58,253
13/05/2017,1,4,10,20,26,41,102
14/05/2017,4,8,29,35,47,52,175
17/05/2017,18,20,30,42,44,47,201
20/05/2017,9,13,45,53,54,55,229
21/05/2017,12,14,20,47,53,57,203
24/05/2017,5,30,36,42,48,51,212
27/05/2017,12,21,37,38,47,54,209
28/05/2017,27,34,37,41,52,53,244
31/05/2017,13,21,29,43,46,58,210
3/6/2017,13,18,22,34,43,46,176
4/6/2017,3,5,18,28,37,58,149
7/6/2017,12,13,22,24,47,57,175
10/6/2017,1,9,16,41,57,58,182
11/6/2017,5,7,9,23,33,35,112
14/06/2017,4,14,45,49,51,54,217
17/06/2017,3,13,14,22,33,58,143
18/06/2017,11,12,16,37,38,51,165
21/06/2017,3,9,20,52,56,58,198
24/06/2017,21,30,46,48,50,53,248
25/06/2017,7,30,36,39,42,44,198
28/06/2017,2,5,23,29,54,56,169
1/7/2017,19,33,44,48,51,53,248
2/7/2017,24,32,37,40,56,58,247
4/7/2017,4,31,36,42,50,56,219
5/7/2017,2,3,5,9,31,39,89
8/7/2017,16,19,23,43,47,50,198
9/7/2017,14,19,20,25,30,41,149
12/7/2017,5,7,14,17,42,43,128
15/07/2017,11,17,27,30,36,58,179
16/07/2017,1,7,8,14,27,44,101
19/07/2017,9,11,18,32,33,49,152
22/07/2017,17,22,27,29,52,56,203
23/07/2017,1,16,21,22,49,57,166
25/07/2017,20,32,33,50,54,57,246
26/07/2017,20,21,33,45,55,57,231
29/07/2017,7,16,18,25,27,50,143
30/07/2017,4,11,17,36,41,44,153
1/8/2017,10,13,14,29,36,54,156
2/8/2017,12,19,23,26,27,56,163
5/8/2017,14,33,37,42,53,56,235
6/8/2017,7,21,26,47,50,54,205
9/8/2017,10,12,15,23,43,49,152
12/8/2017,11,23,27,34,53,54,202
13/08/2017,11,12,30,35,45,47,180
16/08/2017,3,10,20,56,57,58,204
19/08/2017,1,6,28,38,46,57,176
20/08/2017,2,4,6,9,56,57,134
23/08/2017,3,4,11,22,28,56,124
26/08/2017,9,11,12,14,31,53,130
27/08/2017,9,10,14,28,30,55,146
29/08/2017,20,25,27,34,41,46,193
30/08/2017,19,21,32,33,34,55,194
2/9/2017,3,6,22,27,33,39,130
3/9/2017,4,6,11,36,48,50,155
5/9/2017,1,14,15,18,35,43,126
6/9/2017,7,20,32,38,45,49,191
9/9/2017,3,7,12,23,25,46,116
10/9/2017,3,10,27,29,32,48,149
13/09/2017,6,29,31,46,53,58,223
16/09/2017,37,42,44,45,46,54,268
17/09/2017,10,30,33,36,44,45,198
20/09/2017,2,6,13,26,41,48,136
23/09/2017,1,13,33,39,48,54,188
24/09/2017,14,27,28,33,46,47,195
26/09/2017,5,14,24,34,52,53,182
27/09/2017,4,15,18,19,26,57,139
30/09/2017,2,14,20,35,41,45,157
1/10/2017,11,20,29,40,43,57,200
3/10/2017,15,18,29,44,55,58,219
4/10/2017,11,25,27,41,42,49,195
7/10/2017,5,7,26,34,46,50,168
8/10/2017,1,6,15,19,37,40,118
11/10/2017,16,33,38,53,55,57,252
14/10/2017,7,40,44,45,48,57,241
15/10/2017,1,6,9,39,42,58,155
18/10/2017,6,9,27,40,41,50,173
21/10/2017,5,10,31,36,46,53,181
22/10/2017,8,30,32,34,37,39,180
25/10/2017,13,22,24,32,36,39,166
28/10/2017,4,13,19,21,33,58,148
29/10/2017,1,3,6,18,22,52,102
31/10/2017,11,16,18,24,50,58,177
1/11/2017,13,15,16,21,38,47,150
4/11/2017,4,37,50,56,57,58,262
5/11/2017,19,20,42,43,47,53,224
7/11/2017,5,7,17,28,34,37,128
8/11/2017,2,7,17,37,44,55,162
12/11/2017,1,4,6,20,33,41,105
15/11/2017,4,8,29,31,37,44,153
18/11/2017,7,15,16,20,32,52,142
19/11/2017,11,12,20,30,32,49,154
22/11/2017,3,5,30,32,45,55,170
25/11/2017,6,7,17,28,39,58,155
26/11/2017,5,9,29,38,42,52,175
28/11/2017,4,8,40,42,55,56,205
29/11/2017,1,36,42,45,55,58,237
2/12/2017,16,18,24,31,44,54,187
3/12/2017,5,18,21,28,37,49,158
5/12/2017,24,26,28,30,40,54,202
6/12/2017,1,5,10,22,39,45,122
10/12/2017,10,15,23,28,50,53,179
13/12/2017,20,21,23,29,49,56,198
16/12/2017,12,29,31,34,35,39,180
17/12/2017,7,10,14,15,16,26,88
20/12/2017,21,25,27,33,37,46,189
23/12/2017,8,11,13,19,21,24,96
24/12/2017,6,14,16,33,46,58,173
26/12/2017,3,8,21,22,27,57,138
27/12/2017,4,19,21,30,32,46,152
30/12/2017,10,12,41,42,45,51,201
31/12/2017,7,9,27,30,34,54,161
3/1/2018,7,8,24,38,39,54,170
6/1/2018,2,7,26,28,29,30,122
7/1/2018,15,21,44,47,51,55,233
10/1/2018,11,20,38,52,53,55,229
13/01/2018,21,30,41,43,52,58,245
14/01/2018,5,11,15,27,53,58,169
16/01/2018,6,42,44,46,53,57,248
17/01/2018,3,11,37,44,45,47,187
20/01/2018,9,34,36,52,53,55,239
21/01/2018,10,19,29,34,35,54,181
24/01/2018,3,19,20,27,51,58,178
27/01/2018,3,11,16,45,54,58,187
28/01/2018,7,10,22,49,57,58,203
30/01/2018,2,16,30,37,45,54,184
31/01/2018,25,27,36,41,42,58,229
3/2/2018,4,20,35,42,46,58,205
4/2/2018,2,8,23,34,48,58,173
6/2/2018,18,21,26,27,48,52,192
7/2/2018,11,17,18,37,46,54,183
10/2/2018,10,16,22,26,32,42,148
11/2/2018,7,17,20,24,25,31,124
13/02/2018,4,27,44,46,51,55,227
14/02/2018,7,8,15,23,31,36,120
17/02/2018,8,9,14,29,35,48,143
18/02/2018,3,28,33,47,49,53,213
20/02/2018,10,41,42,47,48,57,245
21/02/2018,13,27,34,39,41,45,199
24/02/2018,3,12,26,27,52,58,178
25/02/2018,3,11,31,36,39,46,166
27/02/2018,2,10,17,38,49,50,166
28/02/2018,2,26,30,31,36,49,174
3/3/2018,3,7,20,23,28,58,139
4/3/2018,1,16,37,40,42,45,181
6/3/2018,4,9,34,37,43,49,176
7/3/2018,1,2,8,14,47,52,124
10/3/2018,10,13,21,33,38,54,169
11/3/2018,3,6,26,29,46,55,165
14/03/2018,8,14,17,20,22,28,109
17/03/2018,16,24,25,28,57,58,208
18/03/2018,30,33,41,44,45,52,245
21/03/2018,2,10,16,21,36,39,124
24/03/2018,8,23,26,45,47,56,205
25/03/2018,27,30,33,41,43,48,222
28/03/2018,13,22,31,45,49,50,210
31/03/2018,2,11,35,37,44,56,185
1/4/2018,3,20,25,34,39,47,168
3/4/2018,8,18,32,42,43,48,191
4/4/2018,5,20,26,28,43,46,168
7/4/2018,6,7,11,32,36,42,134
8/4/2018,3,13,15,38,41,54,164
11/4/2018,11,16,25,28,29,32,141
14/04/2018,10,26,27,48,56,57,224
15/04/2018,15,24,40,42,46,55,222
18/04/2018,7,13,34,36,40,47,177
22/04/2018,21,23,38,44,45,57,228
25/04/2018,8,10,24,32,44,57,175
28/04/2018,9,14,23,26,41,46,159
29/04/2018,6,14,20,23,33,57,153
1/5/2018,6,26,30,51,53,54,220
2/5/2018,7,16,25,34,47,57,186
5/5/2018,7,15,28,39,42,47,178
6/5/2018,1,21,23,33,49,50,177
9/5/2018,12,14,24,36,47,54,187
12/5/2018,1,5,12,13,26,29,86
13/05/2018,2,5,8,9,12,15,51
16/05/2018,1,16,17,21,27,36,118
19/05/2018,14,39,40,49,54,57,253
20/05/2018,11,25,36,48,49,54,223
23/05/2018,24,25,30,31,32,54,196
26/05/2018,4,19,25,28,31,38,145
27/05/2018,5,10,14,26,50,53,158
30/05/2018,14,15,19,22,27,39,136
2/6/2018,17,26,27,40,43,50,203
3/6/2018,6,12,35,37,40,49,179
6/6/2018,12,16,17,18,19,49,131
9/6/2018,3,33,38,39,40,51,204
10/6/2018,6,26,29,51,52,56,220
13/06/2018,24,32,37,40,42,49,224
16/06/2018,5,12,14,40,48,53,172
17/06/2018,10,16,24,39,42,50,181
20/06/2018,6,10,17,18,52,54,157
23/06/2018,9,24,32,42,43,57,207
24/06/2018,16,20,38,40,43,55,212
26/06/2018,4,13,15,18,48,56,154
27/06/2018,1,26,31,39,40,52,189
30/06/2018,2,9,33,39,46,57,186
1/7/2018,5,8,24,34,46,54,171
3/7/2018,3,20,29,30,46,54,182
4/7/2018,11,27,37,38,44,51,208
7/7/2018,7,12,20,33,40,53,165
8/7/2018,11,24,31,35,37,44,182
11/7/2018,19,23,29,30,35,51,187
14/07/2018,21,38,39,53,54,56,261
15/07/2018,2,17,19,26,29,56,149
18/07/2018,11,15,18,46,53,58,201
21/07/2018,10,35,45,51,57,58,256
22/07/2018,12,23,28,40,43,56,202
25/07/2018,2,10,31,33,43,47,166
28/07/2018,8,18,28,32,37,43,166
29/07/2018,1,14,21,34,42,52,164
31/07/2018,6,7,20,27,37,38,135
1/8/2018,11,28,32,44,45,52,212
4/8/2018,4,15,23,27,33,37,139
5/8/2018,10,19,20,24,35,41,149
7/8/2018,14,33,34,40,48,58,227
8/8/2018,8,19,30,42,43,54,196
11/8/2018,10,15,17,40,52,57,191
12/8/2018,12,18,30,32,42,50,184
15/08/2018,2,12,14,19,23,25,95
18/08/2018,6,22,27,34,40,50,179
19/08/2018,2,3,6,18,25,45,99
22/08/2018,6,8,10,18,20,38,100
25/08/2018,8,14,26,28,37,49,162
26/08/2018,11,16,24,40,46,54,191
28/08/2018,1,25,32,33,46,52,189
29/08/2018,18,24,25,28,32,33,160
1/9/2018,11,12,43,46,50,58,220
2/9/2018,20,32,43,48,54,55,252
4/9/2018,1,3,7,20,35,58,124
5/9/2018,11,26,31,36,41,52,197
8/9/2018,7,17,26,30,38,40,158
9/9/2018,3,14,17,23,37,38,132
12/9/2018,1,6,14,31,37,43,132
15/09/2018,8,10,20,31,32,41,142
16/09/2018,11,33,43,45,50,57,239
19/09/2018,6,13,29,37,45,46,176
22/09/2018,29,31,39,42,51,53,245
23/09/2018,18,19,28,53,56,58,232
25/09/2018,10,15,18,23,25,52,143
26/09/2018,12,17,26,29,34,37,155
29/09/2018,14,22,36,38,43,45,198
30/09/2018,5,6,7,26,38,57,139
2/10/2018,3,10,13,25,48,49,148
3/10/2018,16,26,30,42,47,49,210
6/10/2018,8,10,28,31,46,47,170
7/10/2018,7,8,15,17,32,43,122
10/10/2018,1,12,29,36,39,42,159
13/10/2018,3,22,27,37,40,54,183
14/10/2018,18,19,34,46,48,57,222
17/10/2018,4,11,20,23,48,55,161
20/10/2018,12,13,19,25,26,39,134
21/10/2018,2,38,44,47,53,57,241
24/10/2018,19,30,35,36,38,49,207
27/10/2018,5,6,32,33,48,53,177
28/10/2018,29,34,35,38,43,49,228
30/10/2018,3,17,26,41,45,46,178
31/10/2018,5,7,34,42,45,55,188
3/11/2018,6,19,25,28,45,49,172
4/11/2018,2,3,14,20,36,57,132
6/11/2018,3,29,30,47,51,52,212
7/11/2018,8,21,29,30,40,48,176
10/11/2018,2,8,12,13,22,57,114
11/11/2018,2,17,24,48,50,56,197
14/11/2018,1,2,8,22,45,54,132
17/11/2018,3,7,10,29,55,58,162
18/11/2018,8,23,24,48,51,58,212
21/11/2018,4,15,18,26,34,47,144
24/11/2018,2,3,25,29,40,50,149
25/11/2018,3,5,30,36,40,55,169
27/11/2018,11,23,26,43,46,52,201
28/11/2018,16,17,25,30,41,54,183
1/12/2018,5,12,32,35,36,45,165
2/12/2018,3,18,37,39,40,49,186
4/12/2018,3,4,5,15,20,23,70
5/12/2018,1,12,26,37,39,50,165
8/12/2018,4,17,25,35,41,58,180
9/12/2018,3,19,36,45,55,56,214
12/12/2018,6,8,13,34,48,55,164
16/12/2018,1,8,12,17,21,25,84
19/12/2018,11,14,38,40,42,43,188
22/12/2018,11,18,25,28,50,52,184
23/12/2018,23,26,36,41,42,53,221
25/12/2018,12,24,30,32,46,48,192
26/12/2018,20,26,29,33,46,47,201
29/12/2018,1,16,34,38,48,58,195
30/12/2018,4,12,17,24,26,39,122
2/1/2019,2,3,19,23,30,49,126
5/1/2019,2,9,24,29,38,45,147
6/1/2019,11,47,49,51,53,55,266
9/1/2019,5,29,30,53,55,57,229
12/1/2019,1,7,29,31,40,51,159
13/01/2019,13,27,30,40,43,51,204
16/01/2019,5,15,18,19,28,53,138
19/01/2019,2,6,23,27,31,43,132
20/01/2019,1,23,25,28,43,49,169
23/01/2019,9,19,24,29,56,57,194
26/01/2019,17,32,33,36,50,53,221
27/01/2019,7,11,18,25,39,58,158
29/01/2019,3,4,41,43,44,52,187
30/01/2019,2,6,16,23,27,32,106
2/2/2019,1,3,13,19,35,58,129
3/2/2019,4,5,6,29,45,55,144
5/2/2019,1,4,5,13,24,56,103
6/2/2019,10,22,35,36,45,58,206
9/2/2019,7,14,16,29,45,57,168
10/2/2019,5,9,13,25,38,40,130
13/02/2019,16,18,22,40,44,54,194
16/02/2019,2,7,12,37,52,56,166
17/02/2019,6,9,13,21,37,43,129
19/02/2019,14,19,38,45,53,55,224
20/02/2019,8,26,42,45,49,53,223
23/02/2019,6,24,27,29,30,43,159
24/02/2019,16,29,31,43,52,54,225
27/02/2019,2,14,16,19,21,37,109
2/3/2019,9,22,24,28,50,58,191
3/3/2019,1,2,19,29,43,54,148
6/3/2019,4,16,19,32,39,50,160
9/3/2019,1,9,15,17,46,48,136
10/3/2019,8,16,27,28,52,55,186
13/03/2019,16,20,30,41,53,58,218
16/03/2019,11,12,19,27,31,36,136
17/03/2019,6,13,14,32,44,50,159
20/03/2019,13,17,33,38,48,58,207
23/03/2019,10,16,22,24,33,49,154
24/03/2019,4,6,18,28,38,58,152
27/03/2019,19,27,42,43,44,48,223
30/03/2019,16,37,38,42,50,53,236
31/03/2019,4,16,18,31,32,44,145
2/4/2019,2,7,38,44,52,55,198
3/4/2019,4,19,27,29,41,47,167
6/4/2019,7,20,33,39,49,57,205
7/4/2019,7,9,11,17,19,25,88
10/4/2019,24,26,27,29,40,50,196
13/04/2019,7,8,14,22,35,58,144
14/04/2019,16,36,47,48,49,50,246
17/04/2019,5,16,22,23,34,52,152
20/04/2019,20,22,24,28,36,57,187
21/04/2019,5,12,14,37,46,53,167
24/04/2019,2,12,13,22,41,56,146
27/04/2019,7,15,18,45,47,55,187
28/04/2019,26,35,36,43,46,54,240
1/5/2019,17,28,30,47,54,55,231
4/5/2019,30,47,48,53,54,57,289
5/5/2019,3,29,36,45,53,55,221
8/5/2019,13,15,18,23,43,52,164
11/5/2019,11,19,21,33,35,58,177
12/5/2019,3,18,40,44,53,58,216
15/05/2019,19,20,25,26,28,52,170
18/05/2019,7,10,14,19,37,54,141
19/05/2019,3,18,31,33,37,44,166
22/05/2019,1,4,18,24,47,50,144
25/05/2019,1,8,11,12,27,53,112
26/05/2019,1,3,15,18,40,46,123
29/05/2019,12,14,29,31,54,55,195
1/6/2019,20,34,39,43,57,58,251
2/6/2019,13,22,27,37,46,53,198
5/6/2019,4,8,14,34,37,48,145
8/6/2019,1,4,8,24,42,45,124
9/6/2019,1,22,24,54,57,58,216
12/6/2019,18,33,35,46,52,58,242
15/06/2019,5,10,17,29,35,41,137
16/06/2019,8,11,36,42,48,51,196
18/06/2019,20,22,25,33,46,53,199
19/06/2019,14,22,27,34,54,56,207
22/06/2019,1,11,27,33,46,52,170
23/06/2019,7,13,14,17,21,56,128
26/06/2019,12,13,15,23,31,58,152
29/06/2019,9,22,28,31,47,54,191
30/06/2019,8,10,22,44,45,51,180
3/7/2019,5,6,13,15,22,24,85
6/7/2019,11,15,27,31,45,58,187
7/7/2019,11,15,20,29,31,41,147
10/7/2019,6,12,15,37,54,55,179
13/07/2019,6,35,40,42,43,45,211
14/07/2019,1,18,35,42,43,58,197
17/07/2019,5,27,30,34,36,49,181
20/07/2019,14,23,31,33,38,45,184
21/07/2019,8,21,28,43,49,58,207
24/07/2019,8,18,32,50,54,55,217
27/07/2019,14,17,24,30,39,46,170
28/07/2019,6,8,22,23,35,41,135
30/07/2019,12,17,23,40,48,52,192
31/07/2019,25,34,35,47,57,58,256
3/8/2019,5,11,16,24,25,43,124
4/8/2019,2,6,13,46,47,51,165
7/8/2019,7,14,24,25,46,49,165
10/8/2019,19,22,27,31,45,50,194
11/8/2019,7,15,22,25,28,50,147
14/08/2019,29,30,46,50,52,54,261
17/08/2019,22,29,34,35,38,53,211
18/08/2019,2,12,14,17,46,48,139
20/08/2019,7,10,18,26,30,51,142
21/08/2019,1,9,12,17,28,38,105
24/08/2019,2,17,21,37,40,55,172
25/08/2019,16,38,46,47,48,50,245
28/08/2019,25,41,44,47,48,56,261
31/08/2019,28,36,39,46,52,56,257
1/9/2019,8,11,19,27,47,55,167
4/9/2019,1,19,24,35,42,49,170
7/9/2019,11,21,29,30,35,41,167
8/9/2019,7,15,31,45,46,58,202
10/9/2019,2,16,19,33,39,58,167
11/9/2019,3,8,19,23,30,51,134
14/09/2019,3,4,7,44,49,52,159
15/09/2019,17,20,23,36,53,58,207
18/09/2019,4,5,37,41,54,58,199
21/09/2019,4,5,17,23,31,34,114
22/09/2019,3,5,6,19,22,35,90
25/09/2019,3,9,17,30,43,47,149
28/09/2019,3,4,14,26,50,57,154
29/09/2019,2,7,25,34,36,50,154
1/10/2019,4,12,13,35,39,54,157
2/10/2019,16,17,19,28,54,55,189
5/10/2019,6,17,21,37,50,52,183
6/10/2019,21,27,38,39,41,46,212
9/10/2019,4,28,40,43,44,58,217
12/10/2019,13,15,36,40,49,57,210
13/10/2019,9,15,21,26,27,53,151
16/10/2019,4,9,13,17,47,58,148
19/10/2019,24,29,33,46,55,57,244
20/10/2019,13,34,38,42,47,48,222
23/10/2019,12,20,30,34,50,51,197
26/10/2019,17,28,29,33,44,53,204
27/10/2019,20,28,46,47,55,57,253
30/10/2019,9,28,30,45,49,53,214
2/11/2019,11,15,22,34,37,57,176
3/11/2019,10,30,42,43,48,58,231
5/11/2019,3,17,32,36,43,49,180
9/11/2019,19,27,34,40,42,55,217
10/11/2019,2,7,11,13,20,42,95
13/11/2019,3,44,45,47,53,56,248
16/11/2019,4,9,17,21,48,50,149
17/11/2019,28,30,33,49,51,52,243
20/11/2019,7,20,25,38,43,56,189
23/11/2019,3,10,17,41,46,47,164
24/11/2019,11,13,50,51,54,55,234
27/11/2019,17,30,39,47,51,52,236
30/11/2019,9,10,17,34,40,51,161
1/12/2019,3,9,17,26,34,50,139
3/12/2019,17,20,21,36,41,50,185
4/12/2019,5,11,21,33,48,57,175
7/12/2019,14,32,37,38,42,56,219
8/12/2019,8,18,31,41,42,48,188
11/12/2019,18,39,40,44,45,49,235
14/12/2019,12,14,31,35,47,57,196
15/12/2019,2,13,25,34,42,48,164
18/12/2019,7,23,25,28,33,56,172
21/12/2019,2,22,26,42,49,55,196
22/12/2019,5,7,27,31,52,57,179
25/12/2019,7,10,11,13,23,45,109
28/12/2019,26,33,36,40,49,52,236
29/12/2019,17,23,27,37,46,51,201
1/1/2020,9,18,48,50,53,57,235
4/1/2020,16,17,34,35,44,52,198
5/1/2020,16,23,25,32,45,57,198
8/1/2020,3,17,36,45,49,50,200
11/1/2020,3,10,11,26,38,53,141
12/1/2020,7,12,31,41,47,49,187
15/01/2020,9,12,17,20,27,28,113
18/01/2020,14,22,25,43,53,54,211
19/01/2020,5,7,32,42,43,58,187
21/01/2020,12,18,44,47,50,54,225
22/01/2020,1,18,26,34,47,55,181
25/01/2020,1,27,29,35,40,50,182
26/01/2020,2,5,11,16,28,36,98
28/01/2020,1,7,18,20,27,34,107
29/01/2020,22,25,38,39,40,53,217
1/2/2020,5,9,15,29,35,51,144
2/2/2020,13,19,24,37,40,42,175
4/2/2020,25,33,44,50,53,56,261
5/2/2020,19,27,34,36,40,52,208
8/2/2020,15,29,31,52,54,58,239
9/2/2020,4,8,11,15,46,47,131
12/2/2020,2,12,16,32,41,52,155
15/02/2020,9,14,16,27,39,49,154
16/02/2020,2,30,46,53,54,57,242
19/02/2020,4,16,23,45,54,56,198
22/02/2020,14,25,42,50,53,56,240
23/02/2020,7,12,13,18,42,52,144
26/02/2020,4,24,35,40,41,48,192
29/02/2020,6,12,33,46,51,56,204
1/3/2020,1,4,15,24,41,43,128
4/3/2020,7,26,39,40,46,57,215
7/3/2020,17,24,47,55,57,58,258
8/3/2020,3,28,38,39,49,50,207
11/3/2020,7,13,20,23,24,27,114
14/03/2020,14,18,21,22,46,49,170
15/03/2020,1,18,19,23,24,58,143
17/06/2020,12,26,31,33,43,54,199
20/06/2020,21,30,43,45,48,56,243
21/06/2020,15,16,32,44,47,50,204
24/06/2020,16,21,36,40,45,56,214
27/06/2020,7,9,14,23,47,53,153
28/06/2020,20,23,26,27,43,57,196
1/7/2020,22,23,27,35,53,58,218
4/7/2020,25,26,40,45,49,58,243
5/7/2020,16,26,28,29,31,36,166
7/7/2020,22,29,31,43,49,57,231
8/7/2020,15,18,29,42,43,51,198
11/7/2020,8,20,37,51,55,58,229
12/7/2020,4,9,29,30,40,49,161
15/07/2020,6,13,17,26,32,47,141
18/07/2020,12,19,27,28,38,50,174
19/07/2020,26,35,46,49,55,57,268
22/07/2020,1,5,22,24,46,52,150
25/07/2020,3,18,36,52,54,57,220
26/07/2020,14,26,29,32,42,47,190
29/07/2020,5,16,18,42,56,58,195
1/8/2020,2,5,17,20,43,54,141
2/8/2020,1,4,5,13,15,41,79
5/8/2020,9,29,30,46,51,58,223
8/8/2020,5,7,22,23,25,47,129
9/8/2020,5,7,9,44,51,57,173
12/8/2020,6,21,42,44,47,52,212
15/08/2020,3,16,31,38,40,53,181
16/08/2020,2,5,8,14,25,30,84
19/08/2020,12,18,39,40,54,58,221
22/08/2020,12,16,35,38,40,41,182
23/08/2020,3,7,25,39,47,52,173
26/08/2020,2,19,23,43,48,51,186
29/08/2020,8,11,18,32,46,52,167
30/08/2020,3,30,31,32,33,38,167
1/9/2020,1,6,34,36,49,58,184
2/9/2020,17,25,39,43,55,57,236
5/9/2020,3,8,17,53,56,58,195
6/9/2020,11,20,27,36,39,40,173
9/9/2020,9,22,23,24,32,36,146
12/9/2020,4,30,43,47,56,58,238
13/09/2020,6,8,10,17,18,52,111
16/09/2020,10,13,26,33,48,50,180
19/09/2020,6,10,17,26,27,32,118
20/09/2020,5,11,18,43,49,55,181
23/09/2020,13,21,25,37,55,57,208
26/09/2020,5,8,9,15,42,43,122
27/09/2020,8,18,29,38,40,49,182
30/09/2020,1,7,17,35,37,40,137
3/10/2020,5,7,14,41,47,56,170
4/10/2020,4,8,32,38,40,50,172
7/10/2020,4,14,23,33,54,56,184
10/10/2020,22,29,31,45,48,53,228
11/10/2020,18,19,24,33,39,44,177
13/10/2020,4,12,14,26,32,35,123
14/10/2020,3,23,31,32,47,53,189
17/10/2020,9,17,30,33,39,58,186
18/10/2020,1,8,33,36,48,58,184
21/10/2020,5,6,24,26,31,46,138
24/10/2020,7,19,48,53,54,56,237
25/10/2020,3,8,12,19,24,44,110
28/10/2020,13,23,29,38,39,43,185
31/10/2020,39,47,52,55,57,58,308
1/11/2020,4,15,19,25,39,42,144
3/11/2020,14,26,28,39,48,52,207
4/11/2020,1,7,26,40,49,55,178
7/11/2020,1,17,20,26,27,34,125
8/11/2020,2,6,10,12,13,48,91
11/11/2020,10,14,24,29,53,57,187
14/11/2020,9,15,18,35,53,56,186
15/11/2020,1,4,16,23,43,50,137
18/11/2020,14,24,33,34,36,46,187
21/11/2020,4,5,14,40,43,50,156
22/11/2020,3,7,17,28,45,50,150
25/11/2020,5,8,11,26,50,51,151
28/11/2020,13,17,19,23,48,49,169
29/11/2020,8,20,25,39,47,51,190
1/9/2020,16,17,19,26,50,56,184
2/9/2020,4,16,31,48,49,50,198
5/9/2020,1,15,22,43,49,50,180
6/9/2020,2,6,23,28,45,56,160
9/9/2020,1,8,10,15,36,38,108
12/9/2020,6,9,10,13,14,24,76
13/09/2020,11,12,16,31,38,46,154
16/09/2020,14,16,32,36,38,51,187
19/09/2020,1,2,5,8,26,56,98
20/09/2020,2,3,20,28,36,53,142
23/09/2020,13,16,34,42,51,53,209
26/09/2020,12,18,37,44,48,55,214
27/09/2020,10,21,26,36,39,40,172
30/09/2020,23,29,34,39,51,56,232
2/1/2021,19,20,29,47,50,52,217
3/1/2021,1,7,28,32,55,57,180
6/1/2021,3,6,8,45,49,55,166
9/1/2021,4,13,19,41,42,57,176
10/1/2021,1,2,4,5,44,46,102
13/01/2021,4,14,47,50,51,57,223
16/01/2021,5,21,27,41,53,56,203
17/01/2021,24,29,33,42,44,53,225
20/01/2021,20,29,31,32,39,48,199
23/01/2021,2,3,15,26,33,46,125
24/01/2021,6,14,20,34,44,57,175
26/01/2021,7,15,21,41,53,55,192
27/01/2021,8,18,19,27,30,54,156
30/01/2021,7,22,26,36,43,45,179
31/01/2021,15,21,23,39,44,51,193
2/2/2021,1,24,25,37,49,55,191
3/2/2021,3,5,14,19,20,38,99
6/2/2021,16,17,31,33,35,51,183
7/2/2021,1,10,12,44,50,58,175
9/2/2021,4,9,26,35,37,53,164
10/2/2021,4,11,12,41,48,50,166
13/02/2021,11,12,14,35,39,49,160
14/02/2021,11,18,27,40,54,56,206
16/02/2021,1,4,19,32,33,42,131
17/02/2021,4,20,22,34,39,58,177
20/02/2021,3,15,24,34,48,52,176
21/02/2021,6,20,31,37,44,54,192
24/02/2021,4,12,22,47,48,50,183
27/02/2021,13,17,24,30,41,54,179
28/02/2021,8,17,30,35,53,58,201
2/3/2021,13,14,31,41,49,53,201
3/3/2021,3,12,22,33,36,41,147
6/3/2021,4,21,34,41,44,52,196
7/3/2021,5,26,28,30,36,44,169
10/3/2021,6,9,10,14,23,31,93
13/03/2021,2,12,18,23,34,51,140
14/03/2021,22,26,45,51,53,55,252
17/03/2021,10,12,13,39,52,53,179
20/03/2021,16,19,21,31,48,56,191
21/03/2021,2,3,8,32,48,50,143
24/03/2021,3,22,32,47,52,57,213
27/03/2021,12,26,31,39,52,53,213
28/03/2021,2,14,16,26,30,33,121
30/03/2021,16,22,34,35,50,58,215
31/03/2021,2,4,17,23,42,43,131
3/4/2021,5,6,23,34,42,53,163
4/4/2021,3,18,28,30,45,46,170
6/4/2021,3,7,20,31,39,55,155
7/4/2021,10,14,30,37,43,44,178
10/4/2021,7,16,22,23,49,56,173
11/4/2021,9,10,15,27,32,42,135
14/04/2021,1,8,11,28,54,56,158
17/04/2021,1,6,18,19,38,45,127
18/04/2021,8,14,24,44,46,49,185
21/04/2021,3,7,12,18,23,49,112
24/04/2021,6,10,34,40,42,43,175
25/04/2021,2,20,22,27,39,47,157
28/04/2021,21,33,34,39,52,55,234
1/5/2021,20,29,34,37,47,49,216
2/5/2021,7,23,24,31,42,56,183
5/5/2021,3,18,19,23,43,47,153
8/5/2021,6,8,14,15,26,29,98
9/5/2021,6,20,24,32,47,52,181
12/5/2021,8,15,37,43,44,45,192
15/05/2021,20,21,31,37,52,55,216
16/05/2021,29,35,38,42,46,51,241
19/05/2021,9,13,22,26,28,40,138
22/05/2021,7,12,17,26,33,51,146
23/05/2021,20,26,35,41,50,57,229
25/05/2021,3,17,34,50,51,54,209
26/05/2021,18,23,25,29,44,56,195
29/05/2021,10,14,21,24,35,38,142
30/05/2021,6,11,16,22,31,55,141
15/09/2021,3,15,18,27,35,55,153
18/09/2021,7,15,17,19,24,36,118
19/09/2021,3,18,33,37,40,57,188
22/09/2021,2,15,22,28,29,55,151
25/09/2021,7,13,25,43,45,50,183
26/09/2021,15,17,20,32,37,45,166
28/09/2021,4,12,24,28,41,53,162
29/09/2021,20,36,39,42,45,50,232
2/10/2021,6,18,20,28,41,51,164
3/10/2021,3,16,20,28,33,44,144
5/10/2021,8,24,26,29,41,56,184
6/10/2021,3,18,19,20,23,51,134
9/10/2021,13,18,38,40,44,47,200
10/10/2021,5,9,15,17,36,42,124
13/10/2021,1,20,36,45,49,51,202
16/10/2021,12,21,31,37,38,52,191
17/10/2021,4,7,18,38,50,54,171
20/10/2021,16,22,28,34,48,58,206
23/10/2021,10,11,23,30,43,55,172
24/10/2021,3,20,25,31,41,53,173
26/10/2021,1,2,25,29,38,57,152
27/10/2021,9,25,37,41,43,48,203
30/10/2021,11,29,30,35,38,45,188
31/10/2021,1,3,13,37,43,50,147
2/11/2021,14,18,22,26,46,55,181
3/11/2021,8,10,11,13,14,17,73
6/11/2021,2,12,22,33,41,42,152
7/11/2021,6,9,15,48,50,54,182
10/11/2021,1,20,40,44,50,51,206
13/11/2021,1,24,27,29,43,47,171
14/11/2021,2,9,11,13,15,35,85
17/11/2021,12,14,20,25,50,52,173
20/11/2021,17,18,26,44,50,51,206
21/11/2021,24,25,31,45,46,52,223
24/11/2021,11,15,21,30,35,54,166
27/11/2021,5,29,39,40,45,51,209
28/11/2021,24,34,45,50,53,54,260
30/11/2021,3,19,29,30,46,47,174
1/12/2021,4,10,11,14,50,53,142
4/12/2021,1,16,18,25,35,49,144
5/12/2021,13,15,25,31,51,53,188
7/12/2021,4,12,19,24,51,52,162
8/12/2021,27,35,42,50,52,58,264
11/12/2021,15,23,30,33,37,41,179
12/12/2021,2,5,8,23,31,51,120
15/12/2021,5,10,29,41,42,45,172
18/12/2021,12,16,22,51,53,58,212
19/12/2021,21,23,36,49,51,56,236
22/12/2021,12,23,50,52,57,58,252
25/12/2021,2,11,43,44,51,58,209
26/12/2021,5,7,32,39,42,53,178
28/12/2021,6,9,22,41,42,45,165
29/12/2021,7,22,24,29,41,46,169
1/1/2022,7,11,20,35,43,57,173
2/1/2022,17,19,23,34,51,53,197
5/1/2022,6,27,34,48,54,56,225
8/1/2022,5,18,24,40,45,55,187
9/1/2022,5,20,28,39,52,55,199
12/1/2022,2,24,37,42,45,48,198
15/01/2022,4,12,18,34,40,54,162
16/01/2022,17,27,31,36,52,58,221
19/01/2022,5,7,11,18,43,53,137
22/01/2022,4,32,42,43,48,55,224
23/01/2022,6,24,25,29,33,46,163
25/01/2022,1,13,25,26,29,43,137
26/01/2022,7,21,23,28,40,50,169
29/01/2022,4,8,26,32,36,44,150
30/01/2022,5,8,41,43,48,53,198
2/2/2022,3,17,28,29,31,37,145
5/2/2022,22,24,27,30,36,49,188
6/2/2022,5,15,24,29,34,53,160
8/2/2022,6,10,24,34,49,54,177
9/2/2022,6,14,16,32,50,53,171
12/2/2022,39,44,46,48,51,56,284
13/02/2022,18,19,21,29,35,53,175
15/02/2022,5,37,40,43,44,46,215
16/02/2022,6,16,26,36,39,49,172
19/02/2022,3,4,9,10,14,35,75
20/02/2022,4,15,23,40,45,54,181
23/02/2022,11,25,28,36,41,46,187
26/02/2022,29,32,43,46,47,48,245
27/02/2022,18,32,33,42,57,58,240
2/3/2022,1,5,12,17,31,57,123
5/3/2022,5,12,20,43,48,54,182
6/3/2022,4,19,35,39,41,46,184
9/3/2022,2,4,11,22,50,57,146
12/3/2022,4,6,32,39,41,45,167
13/03/2022,17,29,38,43,56,57,240
16/03/2022,14,15,34,39,47,52,201
19/03/2022,5,6,9,33,50,56,159
20/03/2022,8,9,24,32,53,56,182
23/03/2022,8,9,21,23,28,44,133
26/03/2022,20,26,38,43,46,58,231
27/03/2022,5,18,25,34,39,49,170
29/03/2022,2,5,12,15,25,27,86
30/03/2022,5,12,20,22,29,41,129
2/4/2022,8,17,33,41,42,55,196
3/4/2022,5,7,21,26,49,56,164
6/4/2022,13,24,25,29,44,50,185
9/4/2022,5,23,32,41,54,55,210
10/4/2022,4,10,21,39,40,44,158
13/04/2022,10,12,15,31,39,58,165
16/04/2022,6,32,37,39,52,53,219
17/04/2022,9,11,16,28,48,53,165
20/04/2022,2,19,26,28,34,44,153
23/04/2022,15,19,21,30,46,55,186
24/04/2022,9,13,26,34,35,46,163
27/04/2022,7,10,21,26,30,58,152
30/04/2022,5,12,26,31,40,56,170
1/5/2022,13,15,29,37,38,40,172
4/5/2022,11,41,46,49,53,57,257
7/5/2022,13,18,33,35,41,42,182
8/5/2022,7,16,26,39,57,58,203
11/5/2022,11,22,35,43,56,58,225
14/05/2022,4,11,12,17,46,48,138
15/05/2022,9,19,24,24,52,54,182
18/05/2022,4,16,26,31,35,57,169
21/05/2022,4,5,27,33,36,48,153
22/05/2022,23,24,27,37,54,56,221
25/05/2022,22,25,31,34,41,46,199
28/05/2022,4,16,48,50,53,58,229
29/05/2022,4,20,35,42,43,46,190
31/05/2022,13,16,17,46,50,54,196
1/6/2022,13,30,35,43,45,57,223
4/6/2022,6,13,23,36,48,50,176
5/6/2022,1,8,14,53,54,57,187
6/6/2022,8,14,27,28,55,56,188
11/6/2022,6,18,27,35,49,58,193
12/6/2022,6,8,11,24,40,46,135
14/06/2022,9,12,15,20,23,57,136
15/06/2022,9,11,19,25,27,54,145
18/06/2022,5,10,22,23,37,39,136
19/06/2022,13,18,24,31,41,52,179
22/06/2022,19,28,30,31,39,44,191
25/06/2022,14,19,20,35,42,57,187
26/06/2022,8,19,22,28,29,44,150
28/06/2022,5,23,29,37,40,44,178
29/06/2022,3,12,17,23,42,55,152
2/7/2022,19,29,34,43,49,55,229
3/7/2022,4,5,24,35,51,56,175
6/7/2022,6,16,31,32,44,51,180
9/7/2022,2,4,6,26,27,28,93
10/7/2022,7,8,10,30,31,35,121
13/07/2022,2,23,26,35,49,51,186
16/07/2022,6,20,41,43,49,50,209
17/07/2022,14,26,27,30,39,52,188
19/07/2022,4,14,16,28,40,42,144
20/07/2022,12,14,19,41,42,58,186
23/07/2022,4,9,33,38,41,45,170
24/07/2022,4,24,25,45,47,54,199
26/07/2022,6,31,36,44,45,50,212
27/07/2022,4,11,17,19,45,55,151
30/07/2022,1,17,25,26,39,51,159
31/07/2022,9,20,21,26,34,40,150
2/8/2022,11,13,17,18,24,27,110
3/8/2022,13,16,35,39,45,48,196
6/8/2022,3,12,42,43,52,53,205
7/8/2022,8,38,43,45,48,52,234
9/8/2022,3,26,33,35,41,49,187
10/8/2022,4,25,36,44,51,53,213
13/08/2022,7,11,22,36,40,56,172
14/08/2022,6,9,26,38,39,48,166
16/08/2022,8,20,26,34,47,51,186
17/08/2022,8,12,14,22,31,36,123
20/08/2022,3,11,25,34,50,58,181
21/08/2022,6,15,25,49,50,56,201
24/08/2022,3,11,24,34,35,45,152
27/08/2022,24,37,40,47,54,57,259
28/08/2022,7,8,11,19,30,56,131
31/08/2022,3,7,24,30,42,55,161
3/9/2022,6,21,30,43,47,53,200
4/9/2022,25,28,31,37,41,52,214
6/9/2022,8,16,17,24,44,57,166
7/9/2022,23,25,39,46,57,58,248
10/9/2022,19,33,42,50,53,54,251
11/9/2022,1,28,37,45,51,54,216
14/09/2022,1,3,9,11,26,47,97
17/09/2022,1,6,8,13,41,42,111
18/09/2022,14,16,19,20,26,55,150
21/09/2022,1,13,21,32,34,45,146
24/09/2022,12,20,33,34,36,43,178
25/09/2022,3,6,8,29,48,53,147
27/09/2022,11,39,42,44,53,57,246
28/09/2022,13,16,17,21,23,50,140
1/10/2022,3,14,17,36,41,47,158
2/10/2022,3,7,12,26,27,55,130
5/10/2022,7,19,27,44,54,57,208
8/10/2022,13,16,27,34,41,42,173
9/10/2022,5,8,22,23,36,41,135
12/10/2022,8,17,32,33,42,55,187
15/10/2022,14,24,32,35,47,56,208
16/10/22,7,8,14,25,26,53,133
18/10/22,37,38,43,49,53,58,278
19/10/22,3,13,23,32,43,46,160
22/10/22,35,36,44,45,47,52,259
23/10/22,20,23,26,49,51,57,226
25/10/22,9,25,40,43,47,55,219
26/10/22,20,38,39,45,51,57,250
29/10/22,32,38,39,43,44,50,246
30/10/22,3,6,26,27,32,45,139
2/11/2022,27,28,30,48,55,56,244
5/11/2022,5,23,25,27,56,57,193
6/11/2022,7,23,31,32,43,56,192
9/11/2022,13,32,40,46,49,57,237
12/11/2022,10,11,18,37,42,58,176
13/11/2022,16,19,22,48,56,58,219
15/11/2022,4,5,11,21,45,55,141
16/11/2022,2,8,27,29,32,54,152
19/11/2022,2,7,9,16,39,46,119
20/11/2022,8,15,24,28,52,56,183
22/11/2022,5,14,26,29,44,54,172
23/11/2022,20,30,34,39,43,53,219
26/11/2022,14,19,25,39,51,53,201
27/11/2022,1,8,12,35,41,54,151
29/11/2022,8,17,22,31,41,49,168
30/11/2022,4,8,11,24,49,57,153
3/12/2022,9,13,21,29,30,53,155
4/12/2022,3,27,29,31,52,54,196
6/12/2022,5,11,20,44,47,50,177
7/12/2022,5,16,27,33,51,52,184
10/12/2022,6,9,11,16,17,27,86
11/12/2022,16,18,22,44,52,53,205
14/12/2022,3,18,19,23,39,55,157
17/12/2022,17,23,25,27,47,51,190
18/12/2022,11,25,29,37,45,47,194
20/12/2022,16,24,32,33,44,46,195
21/12/2022,19,20,26,38,39,55,197
24/12/2022,1,6,8,29,36,58,138
25/12/2022,11,16,39,50,54,57,227
27/12/2022,12,13,23,28,52,55,183
28/12/2022,6,19,25,38,46,50,184
31/12/2022,4,22,30,42,47,49,194
1/1/2023,5,7,16,23,24,28,103
4/1/2023,5,7,21,24,28,55,140
7/1/2023,3,5,27,36,48,50,169
8/1/2023,6,9,10,22,39,56,142
11/1/2023,4,7,10,17,24,32,94
14/01/2023,9,19,35,45,51,54,213
15/01/2023,8,22,36,43,49,58,216
18/01/2023,13,29,31,39,40,41,193
21/01/2023,4,27,32,40,47,50,200
22/01/2023,1,3,30,32,36,46,148
24/01/2023,5,13,15,30,35,58,156
25/01/2023,22,30,33,40,54,57,236
28/01/2023,1,10,26,30,33,43,143
29/01/2023,7,23,31,32,49,52,194
31/01/2023,3,6,17,33,35,49,143
1/2/2023,6,19,25,26,28,56,160
4/2/2023,14,18,39,42,48,53,214
5/2/2023,8,14,19,27,35,55,158
8/2/2023,4,6,8,11,17,22,68
11/2/2023,2,8,10,29,56,58,163
12/2/2023,2,3,13,20,32,37,107
15/02/2023,23,24,27,39,41,47,201
18/02/2023,3,5,15,16,21,52,112
19/02/2023,23,27,32,43,45,48,218
22/02/2023,9,14,15,28,39,48,153
25/02/2023,15,35,38,41,56,57,242
26/02/2023,1,9,14,16,32,37,109
1/3/2023,1,15,45,47,55,57,220
4/3/2023,13,39,44,51,53,56,256
5/3/2023,6,19,21,30,54,55,185
7/3/2023,29,33,37,40,44,48,231
8/3/2023,5,15,27,32,46,57,182
11/3/2023,23,26,29,34,35,49,196
12/3/2023,10,17,40,43,50,54,214
15/03/2023,12,17,27,28,31,33,148
18/03/2023,7,14,15,17,22,50,125
19/03/2023,4,25,32,45,55,58,219
22/03/2023,14,15,32,34,40,41,176
25/03/2023,13,15,31,50,52,56,217
26/03/2023,8,13,19,49,50,54,193
29/03/2023,13,21,24,29,32,44,163
1/4/2023,8,9,22,42,48,50,179
2/4/2023,6,25,29,38,43,45,186
5/4/2023,13,14,35,48,49,55,214
8/4/2023,3,25,31,34,37,53,183
9/4/2023,15,17,20,28,51,52,183
12/4/2023,7,8,26,52,57,58,208
15/04/2023,4,7,16,32,44,49,152
16/04/2023,9,31,35,42,43,48,208
19/04/2023,4,10,17,43,52,54,180
22/04/2023,3,4,11,25,28,32,103
23/04/2023,15,26,33,35,42,53,204
26/04/2023,4,15,16,30,38,58,161
29/04/2023,1,14,23,40,41,48,167
30/04/2023,11,18,22,26,31,36,144
3/5/2023,5,7,28,37,40,57,174
6/5/2023,7,14,25,32,38,47,163
7/5/2023,5,27,36,39,41,46,194
10/5/2023,13,15,31,40,44,46,189
13/05/2023,33,34,41,42,53,57,260
14/05/2023,10,29,33,45,48,55,220
17/05/2023,4,30,37,38,40,44,193
20/05/2023,1,7,10,20,49,57,144
21/05/2023,2,3,4,34,44,46,133
24/05/2023,10,23,35,45,52,57,222
27/05/2023,5,22,26,46,54,55,208
28/05/2023,9,11,19,29,34,52,154
30/05/2023,4,10,17,32,43,45,151
31/05/2023,2,3,7,8,33,55,108
3/6/2023,13,35,37,49,53,57,244
4/6/2023,6,18,19,27,30,52,152
7/6/2023,13,27,33,42,55,58,228
10/6/2023,13,17,31,35,47,48,191
11/6/2023,14,26,37,39,47,56,219
14/06/2023,1,7,28,38,45,47,166
17/06/2023,2,4,21,25,46,53,151
18/06/2023,4,7,13,19,29,53,125
21/06/2023,9,20,27,30,38,48,172
24/06/2023,9,19,23,29,31,43,154
25/06/2023,5,9,25,30,35,55,159
28/06/2023,5,10,38,48,49,57,207
1/7/2023,10,12,25,34,49,54,184
2/7/2023,8,10,15,31,41,47,152
4/7/2023,4,8,13,15,41,42,123
5/7/2023,9,15,18,20,29,40,131
8/7/2023,1,4,6,19,36,47,113
9/7/2023,18,33,45,49,55,58,258
12/7/2023,10,16,23,24,48,50,171
15/07/2023,2,12,27,38,42,50,171
16/07/2023,10,22,34,41,45,56,208
19/07/2023,12,34,42,45,50,51,234
22/07/2023,5,12,22,24,42,51,156
23/07/2023,2,12,22,25,38,40,139
26/07/2023,6,9,17,22,34,53,141
29/07/2023,7,9,24,37,47,56,180
30/07/2023,5,10,14,19,40,43,131
2/8/2023,12,21,25,31,46,54,189
